aa | 啊啊   | 安安   | 嗷嗷   | 😫   | w(ﾟДﾟ)w   | 暗暗   | 爱爱   | 爱啊   | 哎哎   | 唉唉   | 奥奥   | 皑皑   | 按按   | 啊哎   | 昂昂   | 艾艾   | 
aai | 爱爱   | 哎哎   | 唉唉   | 皑皑   | 啊哎   | 艾艾   | 矮矮   | 啊唉   | 啊爱   | 阿爱   | 奥爱   | 啊哎  | 哎哎  | 阿哎  | 爱哎  | 按哎  | 
aan | 安安   | 暗暗   | 按按   | 傲岸   | 荌荌   | 啊按  | 哎按  | 阿按  | 爱按  | 按按  | 唉按  | 安按  | 俺按  | 奥按  | 案按  | 吖按  | 
aang | 昂昂   | 啊昂   | 艾昂   | 啊昂  | 哎昂  | 阿昂  | 爱昂  | 按昂  | 唉昂  | 安昂  | 俺昂  | 奥昂  | 案昂  | 吖昂  | 艾昂  | 昂昂  | 
aao | 嗷嗷   | 奥奥   | 熬熬   | 凹凹   | 袄袄   | 傲傲   | 啊啊哦  | 爱啊哦  | 熬啊哦  | 哎啊哦  | 啊奥  | 哎奥  | 阿奥  | 爱奥  | 按奥  | 唉奥  | 
aba | 阿爸   | 阿坝   | 阿巴   | 爱吧   | 奥巴   | 俺爸   | 熬吧   | 啊吧   | 安吧   | 安霸   | 按吧   | 啊把   | 奥八   | 啊吧  | 哎吧  | 阿吧  | 
abai | 鳌拜   | 阿白   | 安柏   | 啊白   | 爱白   | 安百   | 啊白  | 哎白  | 阿白  | 爱白  | 按白  | 唉白  | 安白  | 俺白  | 奥白  | 案白  | 
aban | 案板   | 爱不爱你   | 凹版   | 安办   | 俺班   | 暗斑   | 阿班   | 奥班   | 澳版   | abandoned   | 啊版  | 哎版  | 阿版  | 爱版  | 按版  | 唉版  | 
abang | 安邦   | 阿邦   | 爱帮   | 奥邦   | 埃镑   | 爱邦   | 啊帮  | 哎帮  | 阿帮  | 爱帮  | 按帮  | 唉帮  | 安帮  | 俺帮  | 奥帮  | 案帮  | 
abao | 安保   | 阿宝   | 敖包   | 爱宝   | 暗堡   | 安宝   | 澳宝   | 艾宝   | 阿包   | 奥宝   | 安包   | 按包   | 阿爆   | 奥爆   | 阿爸哦  | 阿坝哦  | 
abei | 安倍   | 阿贝   | 奥贝   | 阿北   | 爱贝   | 安北   | 奥北   | 澳贝   | 傲北   | 安贝   | 啊被  | 哎被  | 阿被  | 爱被  | 按被  | 唉被  | 
aben | 岸本   | 奥本   | 阿本   | 阿笨   | 按本   | 艾本   | 啊本  | 哎本  | 阿本  | 爱本  | 按本  | 唉本  | 安本  | 俺本  | 奥本  | 案本  | 
abeng | 啊泵   | 啊泵  | 哎泵  | 阿泵  | 爱泵  | 按泵  | 唉泵  | 安泵  | 俺泵  | 奥泵  | 案泵  | 吖泵  | 艾泵  | 昂泵  | 埃泵  | 暗泵  | 
abi | 奥比   | 澳币   | 阿比   | 艾比   | 阿碧   | 爱彼   | 阿鼻   | 暗壁   | 阿吡   | 鞍鼻   | 啊比  | 哎比  | 阿比  | 爱比  | 按比  | 唉比  | 
abian | 岸边   | 阿扁   | 癌变   | 挨边   | 氨苄   | 奥比按  | 澳币按  | 阿比按  | 艾比按  | 阿碧按  | 爱彼按  | 阿鼻按  | 暗壁按  | 阿吡按  | 鞍鼻按  | 啊便  | 
abiang | 啊变更   | 岸边   | 阿扁给  | 癌变给  | 挨边给  | 氨苄给  | 奥比昂  | 澳币昂  | 阿比昂  | 艾比昂  | 阿碧昂  | 爱彼昂  | 阿鼻昂  | 暗壁昂  | 阿吡昂  | 鞍鼻昂  | 
abiao | 阿彪   | 岸标   | 阿标   | 安标   | 暗标   | 按表   | 澳标   | 暗婊   | 奥比奥  | 澳币奥  | 阿比奥  | 艾比奥  | 阿碧奥  | 爱彼奥  | 阿鼻奥  | 暗壁奥  | 
abie | 啊别   | 奥比二  | 澳币二  | 阿比二  | 艾比二  | 阿碧二  | 爱彼二  | 阿鼻二  | 暗壁二  | 阿吡二  | 鞍鼻二  | 啊别  | 哎别  | 阿别  | 爱别  | 按别  | 
abin | 阿斌   | 阿宾   | 阿彬   | 安斌   | 啊斌  | 哎斌  | 阿斌  | 爱斌  | 按斌  | 唉斌  | 安斌  | 俺斌  | 奥斌  | 案斌  | 吖斌  | 艾斌  | 
abing | 阿炳   | 爱兵   | 癌病   | 阿冰   | 暗病   | 阿兵   | 鏖兵   | 啊并  | 哎并  | 阿并  | 爱并  | 按并  | 唉并  | 安并  | 俺并  | 奥并  | 
abo | 阿波   | 阿伯   | 安博   | 奥博   | 阿博   | 爱博   | 艾波   | 安波   | 澳博   | 艾博   | 安播   | 埃博   | 啊波  | 哎波  | 阿波  | 爱波  | 
abu | 阿布   | 暗部   | 奥布   | 啊不   | 阿部   | 俺不   | 爱不   | 爱步   | 安瓿   | 安部   | 庵埠   | 暗补   | 阿不   | 阿卜   | 啊不  | 哎不  | 
aca | 啊擦   | 啊擦  | 哎擦  | 阿擦  | 爱擦  | 按擦  | 唉擦  | 安擦  | 俺擦  | 奥擦  | 案擦  | 吖擦  | 艾擦  | 昂擦  | 埃擦  | 暗擦  | 
acai | 爱财   | 爱才   | 阿财   | 阿彩   | 阿才   | 澳彩   | 安财   | 阿菜   | 安彩   | 熬菜   | 奥彩   | 艾彩   | 啊才  | 哎才  | 阿才  | 爱才  | 
acan | 阿灿   | acanthus   | 啊惨  | 哎惨  | 阿惨  | 爱惨  | 按惨  | 唉惨  | 安惨  | 俺惨  | 奥惨  | 案惨  | 吖惨  | 艾惨  | 昂惨  | 埃惨  | 
acang | 暗藏   | 暗舱   | 昂藏   | 啊仓  | 哎仓  | 阿仓  | 爱仓  | 按仓  | 唉仓  | 安仓  | 俺仓  | 奥仓  | 案仓  | 吖仓  | 艾仓  | 昂仓  | 
acao | 凹槽   | 艾草   | 阿曹   | 啊擦哦  | 啊操  | 哎操  | 阿操  | 爱操  | 按操  | 唉操  | 安操  | 俺操  | 奥操  | 案操  | 吖操  | 艾操  | 
ace | 阿策   | ace   | 啊测  | 哎测  | 阿测  | 爱测  | 按测  | 唉测  | 安测  | 俺测  | 奥测  | 案测  | 吖测  | 艾测  | 昂测  | 埃测  | 
acei | ace i   | 阿策i  | acei  | 啊测i  | 哎测i  | 阿测i  | 爱测i  | 按测i  | 唉测i  | 安测i  | 俺测i  | 奥测i  | 案测i  | 吖测i  | 艾测i  | 昂测i  | 
acen | 啊岑   | 啊岑  | 哎岑  | 阿岑  | 爱岑  | 按岑  | 唉岑  | 安岑  | 俺岑  | 奥岑  | 案岑  | 吖岑  | 艾岑  | 昂岑  | 埃岑  | 暗岑  | 
aceng | 啊曾   | 啊曾  | 哎曾  | 阿曾  | 爱曾  | 按曾  | 唉曾  | 安曾  | 俺曾  | 奥曾  | 案曾  | 吖曾  | 艾曾  | 昂曾  | 埃曾  | 暗曾  | 
acha | 安插   | 爱茶   | 按插   | 阿茶   | Achaean   | 啊差  | 哎差  | 阿差  | 爱差  | 按差  | 唉差  | 安差  | 俺差  | 奥差  | 案差  | 吖差  | 
achai | 安拆   | 阿柴   | 啊拆  | 哎拆  | 阿拆  | 爱拆  | 按拆  | 唉拆  | 安拆  | 俺拆  | 奥拆  | 案拆  | 吖拆  | 艾拆  | 昂拆  | 埃拆  | 
achan | 安产   | 啊产  | 哎产  | 阿产  | 爱产  | 按产  | 唉产  | 安产  | 俺产  | 奥产  | 案产  | 吖产  | 艾产  | 昂产  | 埃产  | 暗产  | 
achang | 案场   | 爱唱   | 阿昌   | 安昌   | 暗娼   | 暗场   | 阿长   | 安畅   | 艾畅   | 啊长  | 哎长  | 阿长  | 爱长  | 按长  | 唉长  | 安长  | 
achao | 阿超   | 爱巢   | 暗潮   | 安超   | 澳超   | 挨吵   | 安插哦  | 爱茶哦  | 按插哦  | 阿茶哦  | 啊超  | 哎超  | 阿超  | 爱超  | 按超  | 唉超  | 
ache | 爱车   | ache   | 啊车  | 哎车  | 阿车  | 爱车  | 按车  | 唉车  | 安车  | 俺车  | 奥车  | 案车  | 吖车  | 艾车  | 昂车  | 埃车  | 
achen | 暗沉   | 阿辰   | 安辰   | 安晨   | 阿晨   | 艾辰   | 阿琛   | 奥宸   | 啊陈   | 啊陈  | 哎陈  | 阿陈  | 爱陈  | 按陈  | 唉陈  | 安陈  | 
acheng | 阿成   | 爱称   | 熬成   | 阿城   | 安城   | 奥城   | 爱城   | 阿诚   | 安成   | 按成   | 安诚   | 澳城   | 案秤   | 啊成  | 哎成  | 阿成  | 
achi | 爱吃   | 奥驰   | 安驰   | 爱驰   | achieve   | 啊吃  | 哎吃  | 阿吃  | 爱吃  | 按吃  | 唉吃  | 安吃  | 俺吃  | 奥吃  | 案吃  | 吖吃  | 
achong | 爱宠   | 奥冲   | 啊冲  | 哎冲  | 阿冲  | 爱冲  | 按冲  | 唉冲  | 安冲  | 俺冲  | 奥冲  | 案冲  | 吖冲  | 艾冲  | 昂冲  | 埃冲  | 
achou | 哀愁   | 阿丑   | 啊抽  | 哎抽  | 阿抽  | 爱抽  | 按抽  | 唉抽  | 安抽  | 俺抽  | 奥抽  | 案抽  | 吖抽  | 艾抽  | 昂抽  | 埃抽  | 
achu | 暗处   | 熬出   | 阿初   | 安处   | 阿楚   | 爱出   | 按出   | 啊出  | 哎出  | 阿出  | 爱出  | 按出  | 唉出  | 安出  | 俺出  | 奥出  | 
achua | 暗处啊   | 暗处啊  | 熬出啊  | 阿初啊  | 安处啊  | 阿楚啊  | 爱出啊  | 按出啊  | 啊欻  | 哎欻  | 阿欻  | 爱欻  | 按欻  | 唉欻  | 安欻  | 俺欻  | 
achuai | 挨踹   | 暗处哎  | 熬出哎  | 阿初哎  | 安处哎  | 阿楚哎  | 爱出哎  | 按出哎  | 啊踹  | 哎踹  | 阿踹  | 爱踹  | 按踹  | 唉踹  | 安踹  | 俺踹  | 
achuan | 阿川   | 安川   | 爱穿   | 暗处按  | 熬出按  | 阿初按  | 安处按  | 阿楚按  | 爱出按  | 按出按  | 啊穿  | 哎穿  | 阿穿  | 爱穿  | 按穿  | 唉穿  | 
achuang | 暗疮   | 奥创   | 安创   | 爱创   | 暗处昂  | 熬出昂  | 阿初昂  | 安处昂  | 阿楚昂  | 爱出昂  | 按出昂  | 啊床  | 哎床  | 阿床  | 爱床  | 按床  | 
achui | 爱吹   | 啊吹  | 哎吹  | 阿吹  | 爱吹  | 按吹  | 唉吹  | 安吹  | 俺吹  | 奥吹  | 案吹  | 吖吹  | 艾吹  | 昂吹  | 埃吹  | 暗吹  | 
achun | 鹌鹑   | 阿春   | 啊春  | 哎春  | 阿春  | 爱春  | 按春  | 唉春  | 安春  | 俺春  | 奥春  | 案春  | 吖春  | 艾春  | 昂春  | 埃春  | 
achuo | 啊戳   | 按错   | 暗处哦  | 熬出哦  | 阿初哦  | 安处哦  | 阿楚哦  | 爱出哦  | 按出哦  | 啊戳  | 哎戳  | 阿戳  | 爱戳  | 按戳  | 唉戳  | 安戳  | 
aci | 按此   | 挨次   | 按次   | 安次   | 安赐   | 暗刺   | 哀辞   | 奥茨   | 啊此  | 哎此  | 阿此  | 爱此  | 按此  | 唉此  | 安此  | 俺此  | 
acong | 啊从   | 阿聪   | 啊从  | 哎从  | 阿从  | 爱从  | 按从  | 唉从  | 安从  | 俺从  | 奥从  | 案从  | 吖从  | 艾从  | 昂从  | 埃从  | 
acou | acoustic   | 哀愁   | 啊凑  | 哎凑  | 阿凑  | 爱凑  | 按凑  | 唉凑  | 安凑  | 俺凑  | 奥凑  | 案凑  | 吖凑  | 艾凑  | 昂凑  | 埃凑  | 
acu | 暗促   | 啊粗  | 哎粗  | 阿粗  | 爱粗  | 按粗  | 唉粗  | 安粗  | 俺粗  | 奥粗  | 案粗  | 吖粗  | 艾粗  | 昂粗  | 埃粗  | 暗粗  | 
acuan | 啊窜   | 暗促按  | 啊窜  | 哎窜  | 阿窜  | 爱窜  | 按窜  | 唉窜  | 安窜  | 俺窜  | 奥窜  | 案窜  | 吖窜  | 艾窜  | 昂窜  | 埃窜  | 
acui | acuity   | 啊崔  | 哎崔  | 阿崔  | 爱崔  | 按崔  | 唉崔  | 安崔  | 俺崔  | 奥崔  | 案崔  | 吖崔  | 艾崔  | 昂崔  | 埃崔  | 暗崔  | 
acun | 安村   | 俺村   | 奥村   | 澳村   | 啊村  | 哎村  | 阿村  | 爱村  | 按村  | 唉村  | 安村  | 俺村  | 奥村  | 案村  | 吖村  | 艾村  | 
acuo | 按错   | 爱错   | 啊错   | 安措   | 暗促哦  | 啊错  | 哎错  | 阿错  | 爱错  | 按错  | 唉错  | 安错  | 俺错  | 奥错  | 案错  | 吖错  | 
ada | 阿达   | 挨打   | 阿大   | 安达   | 昂达   | 安打   | 艾达   | 安大   | 澳大   | 奥达   | 爱打   | 爱达   | 奥大   | 爱大   | 暗打   | 爱哒   | 
adai | 爱戴   | 阿呆   | 阿黛   | 奥黛   | 暗袋   | Adair   | 啊带  | 哎带  | 阿带  | 爱带  | 按带  | 唉带  | 安带  | 俺带  | 奥带  | 案带  | 
adan | 暗淡   | 黯淡   | 阿丹   | 氨氮   | 艾丹   | 按单   | 奥丹   | 阿蛋   | 奥弹   | Adana   | 啊但  | 哎但  | 阿但  | 爱但  | 按但  | 唉但  | 
adang | 爱党   | 爱宕   | 阿当   | 啊当   | 奥当   | 埃当   | 啊当  | 哎当  | 阿当  | 爱当  | 按当  | 唉当  | 安当  | 俺当  | 奥当  | 案当  | 
adao | 哀悼   | 爱到   | 熬到   | 暗道   | 挨到   | 按倒   | 按到   | 挨刀   | 安到   | 安道   | 按道   | 暗刀   | 阿达哦  | 挨打哦  | 阿大哦  | 安达哦  | 
ade | 阿德   | 爱的   | 俺的   | 爱得   | 安德   | 艾德   | 安的   | 奥德   | 安得   | 埃德   | 暗的   | 爱德   | 矮的   | 熬的   | 熬得   | 吖的   | 
adei | 俺得   | 啊得  | 哎得  | 阿得  | 爱得  | 按得  | 唉得  | 安得  | 俺得  | 奥得  | 案得  | 吖得  | 艾得  | 昂得  | 埃得  | 暗得  | 
aden | Aden   | 阿登   | 啊扽  | 哎扽  | 阿扽  | 爱扽  | 按扽  | 唉扽  | 安扽  | 俺扽  | 奥扽  | 案扽  | 吖扽  | 艾扽  | 昂扽  | 埃扽  | 
adeng | 阿登   | 奥登   | 啊等   | 艾登   | 矮凳   | 安灯   | 暗灯   | 按灯   | 阿邓   | 啊等  | 哎等  | 阿等  | 爱等  | 按等  | 唉等  | 安等  | 
adi | 奥迪   | 阿迪   | 安迪   | 艾迪   | 暗地   | 暗帝   | 阿弟   | 埃迪   | 俺滴   | 爱迪   | 案底   | 安地   | 爱地   | 阿娣   | 俺弟   | 按地   | 
adia | adiabatic   | 奥迪啊  | 阿迪啊  | 安迪啊  | 艾迪啊  | 暗地啊  | 暗帝啊  | 阿弟啊  | 埃迪啊  | 俺滴啊  | 爱迪啊  | 案底啊  | 安地啊  | 爱地啊  | 阿娣啊  | 俺弟啊  | 
adian | 暗点   | 按点   | 熬点   | 矮点   | 鞍点   | 凹点   | 暗殿   | 岸电   | 爱点   | 艾蒂安   | 奥迪按  | 阿迪按  | 安迪按  | 艾迪按  | 暗地按  | 暗帝按  | 
adiao | 按掉   | 暗调   | 阿刁   | 挨叼   | 哀吊   | 岸吊   | 阿叼   | 奥迪奥  | 阿迪奥  | 安迪奥  | 艾迪奥  | 暗地奥  | 暗帝奥  | 阿弟奥  | 埃迪奥  | 俺滴奥  | 
adie | 俺爹   | 阿爹   | adieu   | 奥迪二  | 阿迪二  | 安迪二  | 艾迪二  | 暗地二  | 暗帝二  | 阿弟二  | 埃迪二  | 俺滴二  | 爱迪二  | 案底二  | 安地二  | 爱地二  | 
adin | 安定   | 奥丁   | 阿丁   | 爱丁   | 阿顶   | Adina   | 啊顶  | 哎顶  | 阿顶  | 爱顶  | 按顶  | 唉顶  | 安顶  | 俺顶  | 奥顶  | 案顶  | 
ading | 安定   | 奥丁   | 阿丁   | 爱丁   | 阿顶   | 啊顶  | 哎顶  | 阿顶  | 爱顶  | 按顶  | 唉顶  | 安顶  | 俺顶  | 奥顶  | 案顶  | 吖顶  | 
adiu | 啊丢   | 啊丢  | 哎丢  | 阿丢  | 爱丢  | 按丢  | 唉丢  | 安丢  | 俺丢  | 奥丢  | 案丢  | 吖丢  | 艾丢  | 昂丢  | 埃丢  | 暗丢  | 
adong | 安东   | 按动   | 阿东   | 敖东   | 挨冻   | 爱动   | 爱东   | 凹洞   | 阿栋   | 庵东   | 澳东   | 暗洞   | 阿董   | 阿冬   | 艾东   | 啊东  | 
adou | 阿斗   | 爱豆   | 啊都   | 俺都   | 暗斗   | 挨斗   | 阿豆   | 傲斗   | 啊都  | 哎都  | 阿都  | 爱都  | 按都  | 唉都  | 安都  | 俺都  | 
adu | 阿杜   | 爱读   | 安度   | 暗度   | 案牍   | 奥杜   | 安堵   | 爱都   | 阿毒   | 安杜   | 啊都  | 哎都  | 阿都  | 爱都  | 按都  | 唉都  | 
aduan | 拗断   | 按段   | 凹断   | 阿杜按  | 爱读按  | 安度按  | 暗度按  | 案牍按  | 奥杜按  | 安堵按  | 爱都按  | 阿毒按  | 安杜按  | 啊段  | 哎段  | 阿段  | 
adui | 啊对   | 俺对   | 奥对   | 暗队   | 爱对   | 挨怼   | 哎对   | 啊对  | 哎对  | 阿对  | 爱对  | 按对  | 唉对  | 安对  | 俺对  | 奥对  | 
adun | 安顿   | 暗盾   | 奥顿   | 挨顿   | 傲盾   | 按吨   | 埃顿   | 啊吨  | 哎吨  | 阿吨  | 爱吨  | 按吨  | 唉吨  | 安吨  | 俺吨  | 奥吨  | 
aduo | 阿朵   | 奥多   | 安多   | 阿多   | 爱多   | 安朵   | 按多   | 阿杜哦  | 爱读哦  | 安度哦  | 暗度哦  | 案牍哦  | 奥杜哦  | 安堵哦  | 爱都哦  | 阿毒哦  | 
ae | 阿尔   | 啊额   | 埃尔   | 奥尔   | 艾尔   | 挨饿   | 爱尔   | 爱儿   | 安儿   | 啊嗯   | 阿娥   | 艾恩   | 俺儿   | 阿二   | 爱恩   | 奥恩   | 
aei | 啊欸   | 啊欸  | 哎欸  | 阿欸  | 爱欸  | 按欸  | 唉欸  | 安欸  | 俺欸  | 奥欸  | 案欸  | 吖欸  | 艾欸  | 昂欸  | 埃欸  | 暗欸  | 
aen | 啊嗯   | 艾恩   | 爱恩   | 奥恩   | 啊嗯  | 哎嗯  | 阿嗯  | 爱嗯  | 按嗯  | 唉嗯  | 安嗯  | 俺嗯  | 奥嗯  | 案嗯  | 吖嗯  | 艾嗯  | 
aeng | 啊嗯   | 啊鞥  | 哎鞥  | 阿鞥  | 爱鞥  | 按鞥  | 唉鞥  | 安鞥  | 俺鞥  | 奥鞥  | 案鞥  | 吖鞥  | 艾鞥  | 昂鞥  | 埃鞥  | 暗鞥  | 
aer | 阿尔   | 埃尔   | 奥尔   | 艾尔   | 爱尔   | 爱儿   | 安儿   | 俺儿   | 阿二   | 啊二  | 哎二  | 阿二  | 爱二  | 按二  | 唉二  | 安二  | 
afa | 案发   | 阿发   | 奥法   | 阿法   | 挨罚   | 爱发   | 按法   | 安发   | 爱法   | 啊发  | 哎发  | 阿发  | 爱发  | 按发  | 唉发  | 安发  | 
afan | 阿凡   | 案犯   | 奥帆   | 艾凡   | 啊饭  | 哎饭  | 阿饭  | 爱饭  | 按饭  | 唉饭  | 安饭  | 俺饭  | 奥饭  | 案饭  | 吖饭  | 艾饭  | 
afang | 安防   | 安放   | 暗访   | 阿芳   | 暗房   | 阿方   | 澳方   | 爱芳   | 案防   | 艾方   | 啊放  | 哎放  | 阿放  | 爱放  | 按放  | 唉放  | 
afei | 阿飞   | 爱妃   | 艾菲   | 奥菲   | 阿菲   | 奥飞   | 阿肥   | 安菲   | 爱飞   | 安妃   | 啊肥   | 艾飞   | 啊非  | 哎非  | 阿非  | 爱非  | 
afen | 安分   | 阿芬   | 氨酚   | 按份   | 爱芬   | 昂奋   | 啊分  | 哎分  | 阿分  | 爱分  | 按分  | 唉分  | 安分  | 俺分  | 奥分  | 案分  | 
afeng | 阿峰   | 爱疯   | 安丰   | 阿凤   | 暗讽   | 阿风   | 阿锋   | 傲风   | 安峰   | 鳌峰   | 奥丰   | 啊风  | 哎风  | 阿风  | 爱风  | 按风  | 
afiao | 啊覅   | 啊覅  | 哎覅  | 阿覅  | 爱覅  | 按覅  | 唉覅  | 安覅  | 俺覅  | 奥覅  | 案覅  | 吖覅  | 艾覅  | 昂覅  | 埃覅  | 暗覅  | 
afo | 阿佛   | 啊佛  | 哎佛  | 阿佛  | 爱佛  | 按佛  | 唉佛  | 安佛  | 俺佛  | 奥佛  | 案佛  | 吖佛  | 艾佛  | 昂佛  | 埃佛  | 暗佛  | 
afou | 爱否   | 安否   | afoul   | 啊否  | 哎否  | 阿否  | 爱否  | 按否  | 唉否  | 安否  | 俺否  | 奥否  | 案否  | 吖否  | 艾否  | 昂否  | 
afu | 安抚   | 阿福   | 爱抚   | 安福   | 艾弗   | 阿芙   | 奥夫   | 安富   | 阿富   | 澳服   | 暗敷   | 阿父   | 安服   | 奥服   | 艾付   | 奥付   | 
aga | 阿嘎   | 啊噶  | 哎噶  | 阿噶  | 爱噶  | 按噶  | 唉噶  | 安噶  | 俺噶  | 奥噶  | 案噶  | 吖噶  | 艾噶  | 昂噶  | 埃噶  | 暗噶  | 
agai | 暗改   | again   | 啊该  | 哎该  | 阿该  | 爱该  | 按该  | 唉该  | 安该  | 俺该  | 奥该  | 案该  | 吖该  | 艾该  | 昂该  | 埃该  | 
agan | 阿甘   | 安敢   | 爱干   | 阿干   | 啊干  | 哎干  | 阿干  | 爱干  | 按干  | 唉干  | 安干  | 俺干  | 奥干  | 案干  | 吖干  | 艾干  | 
agang | 鞍钢   | 爱岗   | 安钢   | 阿刚   | 暗杠   | 啊杠  | 哎杠  | 阿杠  | 爱杠  | 按杠  | 唉杠  | 安杠  | 俺杠  | 奥杠  | 案杠  | 吖杠  | 
agao | 爱搞   | 哀告   | 熬膏   | 艾高   | 安高   | 阿嘎哦  | 啊高  | 哎高  | 阿高  | 爱高  | 按高  | 唉高  | 安高  | 俺高  | 奥高  | 案高  | 
age | 挨个   | 阿哥   | 奥格   | 艾格   | 按个   | 阿格   | 安格   | 安哥   | 哀歌   | 安个   | 矮个   | 俺哥   | 爱格   | 爱歌   | 暗格   | 熬个   | 
agei | 爱给   | ageism   | 啊给  | 哎给  | 阿给  | 爱给  | 按给  | 唉给  | 安给  | 俺给  | 奥给  | 案给  | 吖给  | 艾给  | 昂给  | 埃给  | 
agen | 阿根   | 铵根   | 奥根   | 艾根   | agencies   | 啊跟  | 哎跟  | 阿跟  | 爱跟  | 按跟  | 唉跟  | 安跟  | 俺跟  | 奥跟  | 案跟  | 吖跟  | 
ageng | 爱庚   | 啊更  | 哎更  | 阿更  | 爱更  | 按更  | 唉更  | 安更  | 俺更  | 奥更  | 案更  | 吖更  | 艾更  | 昂更  | 埃更  | 暗更  | 
agong | 阿公   | 安宫   | 阿贡   | 安工   | 艾工   | 阿工   | 啊共  | 哎共  | 阿共  | 爱共  | 按共  | 唉共  | 安共  | 俺共  | 奥共  | 案共  | 
agou | 爱狗   | 阿狗   | 暗沟   | 爱购   | 啊狗  | 哎狗  | 阿狗  | 爱狗  | 按狗  | 唉狗  | 安狗  | 俺狗  | 奥狗  | 案狗  | 吖狗  | 艾狗  | 
agu | A股   | 傲骨   | 阿古   | 爱股   | 奥古   | 安谷   | 安固   | 艾古   | 俺姑   | 啊古  | 哎古  | 阿古  | 爱古  | 按古  | 唉古  | 安古  | 
agua | 阿瓜   | 傲骨啊  | 阿古啊  | 爱股啊  | 奥古啊  | 安谷啊  | 安固啊  | 艾古啊  | 俺姑啊  | 啊挂  | 哎挂  | 阿挂  | 爱挂  | 按挂  | 唉挂  | 安挂  | 
aguai | 阿怪   | 傲骨哎  | 阿古哎  | 爱股哎  | 奥古哎  | 安谷哎  | 安固哎  | 艾古哎  | 俺姑哎  | 啊怪  | 哎怪  | 阿怪  | 爱怪  | 按怪  | 唉怪  | 安怪  | 
aguan | 安管   | 爱管   | 暗管   | 案管   | 阿官   | 岸罐   | 傲骨按  | 阿古按  | 爱股按  | 奥古按  | 安谷按  | 安固按  | 艾古按  | 俺姑按  | 啊管  | 哎管  | 
aguang | 阿光   | 暗光   | 阿广   | 敖广   | 安广   | 爱逛   | 傲骨昂  | 阿古昂  | 爱股昂  | 奥古昂  | 安谷昂  | 安固昂  | 艾古昂  | 俺姑昂  | 啊光  | 哎光  | 
agui | 昂贵   | 阿贵   | 安规   | 矮柜   | 阿桂   | 阿龟   | 澳规   | Aguilar   | 啊贵  | 哎贵  | 阿贵  | 爱贵  | 按贵  | 唉贵  | 安贵  | 俺贵  | 
agun | 啊滚   | 啊滚  | 哎滚  | 阿滚  | 爱滚  | 按滚  | 唉滚  | 安滚  | 俺滚  | 奥滚  | 案滚  | 吖滚  | 艾滚  | 昂滚  | 埃滚  | 暗滚  | 
aguo | 爱国   | 爱过   | 熬过   | 安国   | 挨过   | 阿国   | 阿果   | 按过   | 傲骨哦  | 阿古哦  | 爱股哦  | 奥古哦  | 安谷哦  | 安固哦  | 艾古哦  | 俺姑哦  | 
aha | 啊哈   | 艾哈   | 阿哈   | 奥哈   | 昂哈   | 啊哈  | 哎哈  | 阿哈  | 爱哈  | 按哈  | 唉哈  | 安哈  | 俺哈  | 奥哈  | 案哈  | 吖哈  | 
ahai | 阿海   | 安海   | 暗害   | 啊还   | 爱海   | 哎嗨   | 奥海   | 澳海   | 啊还  | 哎还  | 阿还  | 爱还  | 按还  | 唉还  | 安还  | 俺还  | 
ahan | 暗含   | 阿含   | 傲寒   | 敖汉   | 阿涵   | 阿翰   | 暗涵   | 啊含  | 哎含  | 阿含  | 爱含  | 按含  | 唉含  | 安含  | 俺含  | 奥含  | 
ahang | 澳航   | 阿航   | 埃航   | 按行   | 啊行  | 哎行  | 阿行  | 爱行  | 按行  | 唉行  | 安行  | 俺行  | 奥行  | 案行  | 吖行  | 艾行  | 
ahao | 爱好   | 安好   | 暗号   | 哀嚎   | 哀号   | 阿豪   | 艾蒿   | 案号   | 阿浩   | 熬好   | 昂好   | 按好   | 阿好   | 哎好   | 啊哈哦  | 艾哈哦  | 
ahe | 爱和   | 爱河   | 爱喝   | 安和   | 阿赫   | 暗合   | 暗盒   | 暗河   | 螯合   | 阿河   | 安河   | 阿和   | 啊和  | 哎和  | 阿和  | 爱和  | 
ahei | 暗黑   | 矮黑   | 阿黑   | 哎嘿   | 黯黑   | 啊黑  | 哎黑  | 阿黑  | 爱黑  | 按黑  | 唉黑  | 安黑  | 俺黑  | 奥黑  | 案黑  | 吖黑  | 
ahen | 爱恨   | 凹痕   | 懊恨   | 啊很  | 哎很  | 阿很  | 爱很  | 按很  | 唉很  | 安很  | 俺很  | 奥很  | 案很  | 吖很  | 艾很  | 昂很  | 
aheng | 安恒   | 阿恒   | 啊哼  | 哎哼  | 阿哼  | 爱哼  | 按哼  | 唉哼  | 安哼  | 俺哼  | 奥哼  | 案哼  | 吖哼  | 艾哼  | 昂哼  | 埃哼  | 
ahm | 俺还没   | 爱很美   | 阿哈姆   | 安徽吗  | 爱好吗  | 爱护吗  | 啊哈吗  | 暗黑吗  | 安好吗  | 爱和吗  | 爱河吗  | 爱恨吗  | 暗号吗  | 懊悔吗  | 爱华吗  | 阿红吗  | 
ahng | 阿航   | 啊很难过   | 爱护你给  | 爱好女给  | 安徽那个  | 爱好那个  | 爱护那个  | 啊哈那个  | 暗黑那个  | 安好那个  | 爱和那个  | 爱河那个  | 爱恨那个  | 暗号那个  | 懊悔那个  | 爱华那个  | 
ahong | 阿红   | 暗红   | 阿訇   | 爱红   | 阿洪   | 安红   | 哀鸿   | 安宏   | 阿虹   | 阿宏   | 阿鸿   | 按宏   | 艾红   | 啊红  | 哎红  | 阿红  | 
ahou | 案后   | 阿侯   | 庵后   | 啊后  | 哎后  | 阿后  | 爱后  | 按后  | 唉后  | 安后  | 俺后  | 奥后  | 案后  | 吖后  | 艾后  | 昂后  | 
ahu | 爱护   | 阿虎   | 艾虎   | 安琥   | 傲虎   | 爱虎   | 按户   | 挨户   | 啊胡  | 哎胡  | 阿胡  | 爱胡  | 按胡  | 唉胡  | 安胡  | 俺胡  | 
ahua | 爱华   | 阿华   | 安华   | 阿花   | 安化   | 暗花   | 爱花   | 矮化   | 艾华   | 奥华   | 澳华   | 氨化   | 暗话   | 胺化   | 昂华   | 爱护啊  | 
ahuai | 爱坏   | 按坏   | 熬坏   | 爱护哎  | 阿虎哎  | 艾虎哎  | 安琥哎  | 傲虎哎  | 爱虎哎  | 按户哎  | 挨户哎  | 啊坏  | 哎坏  | 阿坏  | 爱坏  | 按坏  | 
ahuan | 安环   | 阿欢   | 爱换   | 爱护按  | 阿虎按  | 艾虎按  | 安琥按  | 傲虎按  | 爱虎按  | 按户按  | 挨户按  | 啊换  | 哎换  | 阿换  | 爱换  | 按换  | 
ahuang | 阿黄   | 暗黄   | 澳皇   | 爱护昂  | 阿虎昂  | 艾虎昂  | 安琥昂  | 傲虎昂  | 爱虎昂  | 按户昂  | 挨户昂  | 啊黄  | 哎黄  | 阿黄  | 爱黄  | 按黄  | 
ahui | 安徽   | 懊悔   | 阿辉   | 安慧   | 瑷珲   | 艾回   | 爱会   | 阿慧   | 爱辉   | 安惠   | 暗灰   | 啊会   | 安辉   | 澳汇   | 阿晖   | 啊会  | 
ahun | 安魂   | 暗魂   | 啊混  | 哎混  | 阿混  | 爱混  | 按混  | 唉混  | 安混  | 俺混  | 奥混  | 案混  | 吖混  | 艾混  | 昂混  | 埃混  | 
ahuo | 爱火   | 暗火   | 爱护哦  | 阿虎哦  | 艾虎哦  | 安琥哦  | 傲虎哦  | 爱虎哦  | 按户哦  | 挨户哦  | 啊或  | 哎或  | 阿或  | 爱或  | 按或  | 唉或  | 
aji | 埃及   | 安吉   | 氨基   | 阿吉   | 阿基   | 胺基   | 暗记   | 岸基   | 暗疾   | 按季   | 爱机   | 阿鸡   | 澳际   | 艾吉   | 奥吉   | 案几   | 
ajia | 哀家   | 俺家   | 安家   | 爱家   | 阿加   | 安佳   | 阿嘉   | 爱佳   | 阿甲   | 阿佳   | 挨家   | 奥加   | 艾嘉   | 爱加   | 阿贾   | 安嘉   | 
ajian | 案件   | 按键   | 安检   | 安监   | 暗箭   | 阿健   | 挨肩   | 爱建   | 傲剑   | 熬煎   | 阿剑   | 阿建   | 按件   | 阿坚   | 安健   | 鞍鞯   | 
ajiang | 爱将   | 爱讲   | 暗降   | 鳌江   | 阿江   | 安江   | 爱酱   | 敖江   | 阿酱   | 暗将   | 哀酱   | 安酱   | 埃及昂  | 安吉昂  | 氨基昂  | 阿吉昂  | 
ajiao | 阿娇   | 傲娇   | 暗礁   | 暗角   | 矮脚   | 爱叫   | 艾吉奥   | 熬胶   | 哀叫   | 按脚   | 挨浇   | 哀家哦  | 俺家哦  | 安家哦  | 爱家哦  | 阿加哦  | 
ajie | 按揭   | 阿姐   | 阿杰   | 安杰   | 安捷   | 安洁   | 安姐   | 奥杰   | 俺姐   | 爱姐   | 艾姐   | 阿洁   | 奥捷   | 氨解   | 昂捷   | 奥姐   | 
ajin | 暗金   | 阿金   | 挨近   | 奥金   | 按斤   | 安进   | 凹进   | 按金   | 阿瑾   | 按紧   | 阿进   | 哀矜   | 阿晋   | 啊金  | 哎金  | 阿金  | 
ajing | 安静   | 阿静   | 安井   | 艾敬   | 爱敬   | 爱静   | 爱经   | 安靖   | 阿婧   | 阿晶   | 阿精   | 凹镜   | 暗警   | 啊经  | 哎经  | 阿经  | 
ajiong | 阿囧   | 啊囧  | 哎囧  | 阿囧  | 爱囧  | 按囧  | 唉囧  | 安囧  | 俺囧  | 奥囧  | 案囧  | 吖囧  | 艾囧  | 昂囧  | 埃囧  | 暗囧  | 
ajiu | 艾灸   | 俺就   | 阿九   | 爱就   | 爱酒   | 阿舅   | 安久   | 安九   | 俺舅   | 拗九   | 啊就  | 哎就  | 阿就  | 爱就  | 按就  | 唉就  | 
aju | 安居   | 爱菊   | 阿菊   | 啊据  | 哎据  | 阿据  | 爱据  | 按据  | 唉据  | 安据  | 俺据  | 奥据  | 案据  | 吖据  | 艾据  | 昂据  | 
ajuan | 案卷   | 阿娟   | 爱娟   | 安居按  | 爱菊按  | 阿菊按  | 啊卷  | 哎卷  | 阿卷  | 爱卷  | 按卷  | 唉卷  | 安卷  | 俺卷  | 奥卷  | 案卷  | 
ajue | 暗谲   | 安居二  | 爱菊二  | 阿菊二  | 啊绝  | 哎绝  | 阿绝  | 爱绝  | 按绝  | 唉绝  | 安绝  | 俺绝  | 奥绝  | 案绝  | 吖绝  | 艾绝  | 
ajun | 阿俊   | 爱军   | 傲君   | 阿军   | 爱君   | 阿君   | 安军   | 阿骏   | 安筠   | 啊君   | 啊军  | 哎军  | 阿军  | 爱军  | 按军  | 唉军  | 
aka | 阿卡   | 爱卡   | 安卡   | 奥卡   | 艾卡   | 暗卡   | 啊卡  | 哎卡  | 阿卡  | 爱卡  | 按卡  | 唉卡  | 安卡  | 俺卡  | 奥卡  | 案卡  | 
akai | 阿凯   | 奥凯   | 安凯   | 爱开   | 爱凯   | 暗凯   | 阿开   | Akai   | 啊开  | 哎开  | 阿开  | 爱开  | 按开  | 唉开  | 安开  | 俺开  | 
akan | 爱看   | 俺看   | 奥坎   | 啊看  | 哎看  | 阿看  | 爱看  | 按看  | 唉看  | 安看  | 俺看  | 奥看  | 案看  | 吖看  | 艾看  | 昂看  | 
akang | 安康   | 奥康   | 爱康   | 阿康   | 澳抗   | 暗抗   | 艾康   | 啊康  | 哎康  | 阿康  | 爱康  | 按康  | 唉康  | 安康  | 俺康  | 奥康  | 
akao | 啊靠   | 安靠   | 挨靠   | 阿卡哦  | 爱卡哦  | 安卡哦  | 奥卡哦  | 艾卡哦  | 暗卡哦  | 啊靠  | 哎靠  | 阿靠  | 爱靠  | 按靠  | 唉靠  | 安靠  | 
ake | 艾克   | 阿克   | 埃克   | 奥克   | 阿珂   | 安可   | 安科   | 爱克   | 阿科   | 奥科   | 艾柯   | 昂克   | 澳客   | 阿柯   | 艾可   | 艾科   | 
akei | 啊剋   | 啊剋  | 哎剋  | 阿剋  | 爱剋  | 按剋  | 唉剋  | 安剋  | 俺剋  | 奥剋  | 案剋  | 吖剋  | 艾剋  | 昂剋  | 埃剋  | 暗剋  | 
aken | 艾肯   | 阿肯   | 哀恳   | 啊肯  | 哎肯  | 阿肯  | 爱肯  | 按肯  | 唉肯  | 安肯  | 俺肯  | 奥肯  | 案肯  | 吖肯  | 艾肯  | 昂肯  | 
akeng | 凹坑   | 哎坑   | 啊坑  | 哎坑  | 阿坑  | 爱坑  | 按坑  | 唉坑  | 安坑  | 俺坑  | 奥坑  | 案坑  | 吖坑  | 艾坑  | 昂坑  | 埃坑  | 
akong | 阿空   | 安控   | 啊空   | 啊空  | 哎空  | 阿空  | 爱空  | 按空  | 唉空  | 安空  | 俺空  | 奥空  | 案空  | 吖空  | 艾空  | 昂空  | 
akou | 拗口   | 隘口   | 碍口   | 暗扣   | 按扣   | 凹口   | 安口   | 啊口  | 哎口  | 阿口  | 爱口  | 按口  | 唉口  | 安口  | 俺口  | 奥口  | 
aku | 爱哭   | 奥库   | 阿酷   | 哀哭   | 爱酷   | 啊库  | 哎库  | 阿库  | 爱库  | 按库  | 唉库  | 安库  | 俺库  | 奥库  | 案库  | 吖库  | 
akua | 阿夸   | 爱哭啊  | 奥库啊  | 阿酷啊  | 哀哭啊  | 爱酷啊  | 啊跨  | 哎跨  | 阿跨  | 爱跨  | 按跨  | 唉跨  | 安跨  | 俺跨  | 奥跨  | 案跨  | 
akuai | 爱快   | 啊快   | 按快   | 爱哭哎  | 奥库哎  | 阿酷哎  | 哀哭哎  | 爱酷哎  | 啊快  | 哎快  | 阿快  | 爱快  | 按快  | 唉快  | 安快  | 俺快  | 
akuan | 阿宽   | 案款   | 爱哭按  | 奥库按  | 阿酷按  | 哀哭按  | 爱酷按  | 啊款  | 哎款  | 阿款  | 爱款  | 按款  | 唉款  | 安款  | 俺款  | 奥款  | 
akuang | 澳矿   | 爱哭昂  | 奥库昂  | 阿酷昂  | 哀哭昂  | 爱酷昂  | 啊狂  | 哎狂  | 阿狂  | 爱狂  | 按狂  | 唉狂  | 安狂  | 俺狂  | 奥狂  | 案狂  | 
akui | 阿奎   | 暗亏   | 啊亏  | 哎亏  | 阿亏  | 爱亏  | 按亏  | 唉亏  | 安亏  | 俺亏  | 奥亏  | 案亏  | 吖亏  | 艾亏  | 昂亏  | 埃亏  | 
akun | 阿坤   | 安坤   | 奥昆   | 爱困   | 啊困  | 哎困  | 阿困  | 爱困  | 按困  | 唉困  | 安困  | 俺困  | 奥困  | 案困  | 吖困  | 艾困  | 
akuo | 澳阔   | 爱哭哦  | 奥库哦  | 阿酷哦  | 哀哭哦  | 爱酷哦  | 啊阔  | 哎阔  | 阿阔  | 爱阔  | 按阔  | 唉阔  | 安阔  | 俺阔  | 奥阔  | 案阔  | 
ala | 阿拉   | 奥拉   | 安啦   | 安拉   | 艾拉   | 啊啦   | 啊拉   | 爱拉   | 埃拉   | 啊啦  | 哎啦  | 阿啦  | 爱啦  | 按啦  | 唉啦  | 安啦  | 
alai | 奥莱   | 阿来   | 阿莱   | 爱来   | 傲来   | 阿赖   | 俺来   | 啊来   | 安来   | 艾莱   | alai   | 啊来  | 哎来  | 阿来  | 爱来  | 按来  | 
alan | 阿兰   | 奥兰   | 安澜   | 埃兰   | 爱兰   | 艾兰   | 阿岚   | 暗蓝   | 奥丽安娜   | 安岚   | 昂蓝   | Alan   | 啊蓝  | 哎蓝  | 阿蓝  | 爱蓝  | 
alang | 阿郎   | 阿朗   | 阿浪   | 爱郎   | 阿狼   | 爱浪   | 奥朗   | 艾朗   | 啊狼  | 哎狼  | 阿狼  | 爱狼  | 按狼  | 唉狼  | 安狼  | 俺狼  | 
alao | 爱老   | 安老   | 按劳   | 阿拉哦  | 奥拉哦  | 安啦哦  | 安拉哦  | 艾拉哦  | 啊啦哦  | 啊拉哦  | 爱拉哦  | 埃拉哦  | 啊老  | 哎老  | 阿老  | 爱老  | 
ale | 爱了   | 安乐   | 按了   | 阿勒   | 挨了   | 熬了   | 安了   | 阿乐   | 暗了   | 奥勒   | 矮了   | 艾乐   | 奥乐   | 澳乐   | 爱乐   | 啊了  | 
alei | 阿雷   | 奥雷   | 胺类   | 埃雷   | 啊嘞   | 阿磊   | 暗雷   | 阿蕾   | 安磊   | 艾蕾   | 安雷   | 昂类   | 啊类  | 哎类  | 阿类  | 爱类  | 
alen | 阿冷   | 啊冷   | 爱人   | 啊冷  | 哎冷  | 阿冷  | 爱冷  | 按冷  | 唉冷  | 安冷  | 俺冷  | 奥冷  | 案冷  | 吖冷  | 艾冷  | 昂冷  | 
aleng | 阿冷   | 啊冷   | 啊冷  | 哎冷  | 阿冷  | 爱冷  | 按冷  | 唉冷  | 安冷  | 俺冷  | 奥冷  | 案冷  | 吖冷  | 艾冷  | 昂冷  | 埃冷  | 
ali | 案例   | 阿里   | 安利   | 奥利   | 按理   | 阿狸   | 奥里   | 艾莉   | 阿利   | 爱丽   | 艾利   | 艾力   | 暗里   | 艾丽   | 阿丽   | 昂立   | 
alia | 俺俩   | alias   | 案例啊  | 阿里啊  | 安利啊  | 奥利啊  | 按理啊  | 阿狸啊  | 奥里啊  | 艾莉啊  | 阿利啊  | 爱丽啊  | 艾利啊  | 艾力啊  | 暗里啊  | 艾丽啊  | 
alian | 阿联   | 暗恋   | 爱恋   | 安联   | 阿莲   | 爱怜   | 爱莲   | 哀怜   | 爱联   | 熬炼   | 谙练   | 案例按  | 阿里按  | 安利按  | 奥利按  | 按理按  | 
aliang | 按量   | 阿亮   | 阿良   | 安良   | 阿凉   | 暗梁   | 阿梁   | 安粮   | 案例昂  | 阿里昂  | 安利昂  | 奥利昂  | 按理昂  | 阿狸昂  | 奥里昂  | 艾莉昂  | 
aliao | 奥利奥   | 爱聊   | 阿辽   | 俺俩哦  | 案例奥  | 阿里奥  | 安利奥  | 奥利奥  | 按理奥  | 阿狸奥  | 奥里奥  | 艾莉奥  | 阿利奥  | 爱丽奥  | 艾利奥  | 艾力奥  | 
alie | 案列   | 奥列   | 啊咧   | 按列   | 暗猎   | aliens   | 案例二  | 阿里二  | 安利二  | 奥利二  | 按理二  | 阿狸二  | 奥里二  | 艾莉二  | 阿利二  | 爱丽二  | 
alin | 艾琳   | 奥林   | 阿林   | 爱琳   | 阿琳   | 爱林   | 艾林   | 安林   | 挨淋   | 奥琳   | 啊林  | 哎林  | 阿林  | 爱林  | 按林  | 唉林  | 
aling | 爱玲   | 阿玲   | 按铃   | 阿绫   | 暗灵   | 艾玲   | 奥铃   | 安岭   | 啊零  | 哎零  | 阿零  | 爱零  | 按零  | 唉零  | 安零  | 俺零  | 
aliu | 暗流   | 癌瘤   | 啊六  | 哎六  | 阿六  | 爱六  | 按六  | 唉六  | 安六  | 俺六  | 奥六  | 案六  | 吖六  | 艾六  | 昂六  | 埃六  | 
alo | 安咯   | 啊咯   | 啊咯  | 哎咯  | 阿咯  | 爱咯  | 按咯  | 唉咯  | 安咯  | 俺咯  | 奥咯  | 案咯  | 吖咯  | 艾咯  | 昂咯  | 埃咯  | 
along | 阿龙   | 阿隆   | 安龙   | 傲龙   | 奥龙   | 暗龙   | 埃隆   | 澳龙   | 爱龙   | 艾龙   | along   | 啊龙  | 哎龙  | 阿龙  | 爱龙  | 按龙  | 
alou | 安喽   | aloud   | 啊楼  | 哎楼  | 阿楼  | 爱楼  | 按楼  | 唉楼  | 安楼  | 俺楼  | 奥楼  | 案楼  | 吖楼  | 艾楼  | 昂楼  | 埃楼  | 
alu | 阿鲁   | 安陆   | 安路   | 阿卢   | 奥路   | 艾鲁   | 艾路   | 艾露   | 隘路   | 安麓   | 暗路   | 爱炉   | 奥鹿   | 熬路   | 啊路  | 哎路  | 
aluan | 阿鸾   | 阿鲁按  | 安陆按  | 安路按  | 阿卢按  | 奥路按  | 艾鲁按  | 艾路按  | 艾露按  | 隘路按  | 安麓按  | 暗路按  | 爱炉按  | 奥鹿按  | 熬路按  | 啊乱  | 
alun | 艾伦   | 阿伦   | 氨纶   | 奥伦   | 爱伦   | 啊论  | 哎论  | 阿论  | 爱论  | 按论  | 唉论  | 安论  | 俺论  | 奥论  | 案论  | 吖论  | 
aluo | 阿罗   | 埃罗   | 阿洛   | 奥罗   | 奥洛   | 爱罗   | 爱洛   | 爱络   | 埃洛   | 阿鲁哦  | 安陆哦  | 安路哦  | 阿卢哦  | 奥路哦  | 艾鲁哦  | 艾路哦  | 
alv | 爱侣   | 暗绿   | 阿绿   | 氨氯   | 哀绿   | 澳旅   | 啊率  | 哎率  | 阿率  | 爱率  | 按率  | 唉率  | 安率  | 俺率  | 奥率  | 案率  | 
alve | alveolar   | 挨虐   | 爱侣二  | 暗绿二  | 阿绿二  | 氨氯二  | 哀绿二  | 澳旅二  | 啊略  | 哎略  | 阿略  | 爱略  | 按略  | 唉略  | 安略  | 俺略  | 
am | 澳门   | 奥秘   | 按摩   | 暧昧   | 上午   | 俺们   | 阿门   | 艾玛   | 傲慢   | 挨骂   | 爱慕   | 爱美   | 阿玛   | 艾米   | 奥妙   | 阿妈   | 
ama | 艾玛   | 挨骂   | 阿玛   | 阿妈   | 俺妈   | 爱吗   | 爱玛   | 鞍马   | 阿马   | 奥马   | 奥玛   | 暗骂   | 啊吗   | 啊嘛   | 矮马   | 爱马   | 
amai | 爱买   | 按脉   | 暗埋   | 爱卖   | 啊买   | 安迈   | 澳麦   | 啊买  | 哎买  | 阿买  | 爱买  | 按买  | 唉买  | 安买  | 俺买  | 奥买  | 
aman | 傲慢   | 阿曼   | 阿蛮   | 安曼   | 艾曼   | 阿满   | 安缦   | 安满   | 奥曼   | Amanda   | 啊满  | 哎满  | 阿满  | 爱满  | 按满  | 唉满  | 
amang | 澳芒   | 傲慢   | 啊忙  | 哎忙  | 阿忙  | 爱忙  | 按忙  | 唉忙  | 安忙  | 俺忙  | 奥忙  | 案忙  | 吖忙  | 艾忙  | 昂忙  | 埃忙  | 
amao | 阿毛   | 爱猫   | 阿猫   | 澳毛   | 暗矛   | 阿茂   | 艾玛哦  | 挨骂哦  | 阿玛哦  | 阿妈哦  | 俺妈哦  | 爱吗哦  | 爱玛哦  | 鞍马哦  | 阿马哦  | 奥马哦  | 
ame | 爱么   | 俺么   | 奥么   | 昂么   | 啊么   | 阿么   | 啊么  | 哎么  | 阿么  | 爱么  | 按么  | 唉么  | 安么  | 俺么  | 奥么  | 案么  | 
amei | 暧昧   | 爱美   | 阿妹   | 阿梅   | 阿美   | 奥美   | 艾美   | 安美   | 俺没   | 爱梅   | 傲梅   | 澳美   | 俺妹   | 暗昧   | 艾梅   | 埃美   | 
amen | 澳门   | 俺们   | 阿门   | 暗门   | 安门   | 挨门   | amen   | 啊们  | 哎们  | 阿们  | 爱们  | 按们  | 唉们  | 安们  | 俺们  | 奥们  | 
ameng | 阿蒙   | 埃蒙   | 阿盟   | 阿萌   | 阿猛   | 爱梦   | 安盟   | 阿梦   | 阿孟   | 安梦   | 艾萌   | 傲梦   | 啊梦  | 哎梦  | 阿梦  | 爱梦  | 
ami | 奥秘   | 艾米   | 阿米   | 埃米   | 安谧   | 阿咪   | 阿迷   | 爱米   | 阿密   | 安米   | 阿蜜   | 按米   | 艾咪   | 啊米  | 哎米  | 阿米  | 
amian | 安眠   | 凹面   | 暗面   | 爱面   | 奥秘按  | 艾米按  | 阿米按  | 埃米按  | 安谧按  | 阿咪按  | 阿迷按  | 爱米按  | 阿密按  | 安米按  | 阿蜜按  | 按米按  | 
amiao | 奥妙   | 阿喵   | 啊喵   | 按秒   | 阿苗   | 爱喵   | 澳妙   | 奥秘奥  | 艾米奥  | 阿米奥  | 埃米奥  | 安谧奥  | 阿咪奥  | 阿迷奥  | 爱米奥  | 阿密奥  | 
amie | 暗灭   | 黯灭   | Amie   | 奥秘二  | 艾米二  | 阿米二  | 埃米二  | 安谧二  | 阿咪二  | 阿迷二  | 爱米二  | 阿密二  | 安米二  | 阿蜜二  | 按米二  | 艾咪二  | 
amin | 爱民   | 阿敏   | 安民   | 艾敏   | 安敏   | Amin   | 啊民  | 哎民  | 阿民  | 爱民  | 按民  | 唉民  | 安民  | 俺民  | 奥民  | 案民  | 
aming | 阿明   | 哀鸣   | 案名   | 安明   | 爱明   | 阿铭   | 奥明   | 爱名   | 啊名  | 哎名  | 阿名  | 爱名  | 按名  | 唉名  | 安名  | 俺名  | 
amiu | 啊谬   | 啊缪  | 哎缪  | 阿缪  | 爱缪  | 按缪  | 唉缪  | 安缪  | 俺缪  | 奥缪  | 案缪  | 吖缪  | 艾缪  | 昂缪  | 埃缪  | 暗缪  | 
amo | 按摩   | 阿莫   | 阿嬷   | 阿默   | 凹模   | 熬磨   | 癌魔   | 奥摩   | 奥默   | 鏖魔   | 埃莫   | 啊莫  | 哎莫  | 阿莫  | 爱莫  | 按莫  | 
amou | amount   | 啊某  | 哎某  | 阿某  | 爱某  | 按某  | 唉某  | 安某  | 俺某  | 奥某  | 案某  | 吖某  | 艾某  | 昂某  | 埃某  | 暗某  | 
amu | 爱慕   | 阿姆   | 阿木   | 暗牧   | 奥姆   | 桉木   | 凹模   | 澳牧   | 啊木  | 哎木  | 阿木  | 爱木  | 按木  | 唉木  | 安木  | 俺木  | 
an | 按   | 安   | 俺   | 案   | 暗   | 岸   | 庵   | 胺   | 氨   | 鞍   | 铵   | 黯   | 谙   | 桉   | 唵   | 鹌   | 
ana | 阿纳   | 啊那   | 阿娜   | 婀娜   | 按啊  | 安啊  | 俺啊  | 案啊  | 暗啊  | 岸啊  | 庵啊  | 胺啊  | 氨啊  | 鞍啊  | 铵啊  | 黯啊  | 
anai | 阿奶   | 按哎  | 安哎  | 俺哎  | 案哎  | 暗哎  | 岸哎  | 庵哎  | 胺哎  | 氨哎  | 鞍哎  | 铵哎  | 黯哎  | 谙哎  | 桉哎  | 唵哎  | 
anan | 安安   | 爱你爱你爱你   | 暗暗   | 爱你爱你   | 按按   | 阿南   | 阿难   | 阿囡   | 荌荌   | 按按  | 安按  | 俺按  | 案按  | 暗按  | 岸按  | 庵按  | 
anang | 按昂   | 安安   | 按昂  | 安昂  | 俺昂  | 案昂  | 暗昂  | 岸昂  | 庵昂  | 胺昂  | 氨昂  | 鞍昂  | 铵昂  | 黯昂  | 谙昂  | 桉昂  | 
anao | 啊闹   | 阿纳哦  | 啊那哦  | 阿娜哦  | 婀娜哦  | 按奥  | 安奥  | 俺奥  | 案奥  | 暗奥  | 岸奥  | 庵奥  | 胺奥  | 氨奥  | 鞍奥  | 铵奥  | 
ane | 阿讷   | 按二  | 安二  | 俺二  | 案二  | 暗二  | 岸二  | 庵二  | 胺二  | 氨二  | 鞍二  | 铵二  | 黯二  | 谙二  | 桉二  | 唵二  | 
anei | 阿内   | 按欸  | 安欸  | 俺欸  | 案欸  | 暗欸  | 岸欸  | 庵欸  | 胺欸  | 氨欸  | 鞍欸  | 铵欸  | 黯欸  | 谙欸  | 桉欸  | 唵欸  | 
anen | 安恩   | 按嗯  | 安嗯  | 俺嗯  | 案嗯  | 暗嗯  | 岸嗯  | 庵嗯  | 胺嗯  | 氨嗯  | 鞍嗯  | 铵嗯  | 黯嗯  | 谙嗯  | 桉嗯  | 唵嗯  | 
aneng | 啊能   | 按鞥  | 安鞥  | 俺鞥  | 案鞥  | 暗鞥  | 岸鞥  | 庵鞥  | 胺鞥  | 氨鞥  | 鞍鞥  | 铵鞥  | 黯鞥  | 谙鞥  | 桉鞥  | 唵鞥  | 
ang | 昂   | 盎   | 肮   | 卬   | 岇   | 枊   | 醠   | 昻   | 醃   | 骯   | 屽给  | 誝给  | 諳给  | 裺给  | 垵给  | 隌给  | 
ani | 啊你   | 阿尼   | 阿妮   | 啊你  | 阿你  | 吖你  | 嗄你  | 锕你  | 呵你  | 腌你  | 錒你  | 屽i  | 誝i  | 諳i  | 裺i  | 垵i  | 
ania | 阿娘   | 阿年   | 啊你啊  | 阿尼啊  | 阿妮啊  | 啊年  | 阿年  | 吖年  | 嗄年  | 锕年  | 呵年  | 腌年  | 錒年  | 屽ia  | 誝ia  | 諳ia  | 
anian | 啊你按   | 阿联   | 阿年   | 啊你按  | 阿尼按  | 阿妮按  | 啊年  | 阿年  | 吖年  | 嗄年  | 锕年  | 呵年  | 腌年  | 錒年  | 屽ian  | 誝ian  | 
aniang | 阿娘   | 啊你昂  | 阿尼昂  | 阿妮昂  | 啊娘  | 阿娘  | 吖娘  | 嗄娘  | 锕娘  | 呵娘  | 腌娘  | 錒娘  | 屽iang  | 誝iang  | 諳iang  | 裺iang  | 
aniao | 啊鸟   | 啊你奥  | 阿尼奥  | 阿妮奥  | 啊鸟  | 阿鸟  | 吖鸟  | 嗄鸟  | 锕鸟  | 呵鸟  | 腌鸟  | 錒鸟  | 屽iao  | 誝iao  | 諳iao  | 裺iao  | 
anie | 啊捏   | 啊你二  | 阿尼二  | 阿妮二  | 啊捏  | 阿捏  | 吖捏  | 嗄捏  | 锕捏  | 呵捏  | 腌捏  | 錒捏  | 屽ie  | 誝ie  | 諳ie  | 裺ie  | 
anin | 啊您   | 啊您  | 阿您  | 吖您  | 嗄您  | 锕您  | 呵您  | 腌您  | 錒您  | 屽in  | 誝in  | 諳in  | 裺in  | 垵in  | 隌in  | 碪in  | 
aning | 阿宁   | 按ing  | 安ing  | 俺ing  | 案ing  | 暗ing  | 岸ing  | 庵ing  | 胺ing  | 氨ing  | 鞍ing  | 铵ing  | 黯ing  | 谙ing  | 桉ing  | 唵ing  | 
aniu | 阿牛   | 阿妞   | 啊牛  | 阿牛  | 吖牛  | 嗄牛  | 锕牛  | 呵牛  | 腌牛  | 錒牛  | 屽iu  | 誝iu  | 諳iu  | 裺iu  | 垵iu  | 隌iu  | 
anong | 啊弄   | 啊弄  | 阿弄  | 吖弄  | 嗄弄  | 锕弄  | 呵弄  | 腌弄  | 錒弄  | 按哦那个  | 屽哦那个  | 誝哦那个  | 諳哦那个  | 裺哦那个  | 垵哦那个  | 隌哦那个  | 
anou | 阿耨   | 按偶  | 安偶  | 俺偶  | 案偶  | 暗偶  | 岸偶  | 庵偶  | 胺偶  | 氨偶  | 鞍偶  | 铵偶  | 黯偶  | 谙偶  | 桉偶  | 唵偶  | 
anu | 阿奴   | 啊怒  | 阿怒  | 吖怒  | 嗄怒  | 锕怒  | 呵怒  | 腌怒  | 錒怒  | 屽u  | 誝u  | 諳u  | 裺u  | 垵u  | 隌u  | 碪u  | 
anuan | 啊暖   | 阿暖   | 阿奴按  | 啊暖  | 阿暖  | 吖暖  | 嗄暖  | 锕暖  | 呵暖  | 腌暖  | 錒暖  | 屽店  | 誝店  | 諳店  | 裺店  | 垵店  | 
anun | 啊黁   | 啊黁  | 阿黁  | 吖黁  | 嗄黁  | 锕黁  | 呵黁  | 腌黁  | 錒黁  | 屽丶  | 誝丶  | 諳丶  | 裺丶  | 垵丶  | 隌丶  | 碪丶  | 
anuo | 阿诺   | 阿奴哦  | 啊诺  | 阿诺  | 吖诺  | 嗄诺  | 锕诺  | 呵诺  | 腌诺  | 錒诺  | 屽uo  | 誝uo  | 諳uo  | 裺uo  | 垵uo  | 隌uo  | 
anv | 啊女   | 啊女  | 阿女  | 吖女  | 嗄女  | 锕女  | 呵女  | 腌女  | 錒女  | 屽v  | 誝v  | 諳v  | 裺v  | 垵v  | 隌v  | 碪v  | 
anve | 啊虐   | 啊虐  | 阿虐  | 吖虐  | 嗄虐  | 锕虐  | 呵虐  | 腌虐  | 錒虐  | 屽ve  | 誝ve  | 諳ve  | 裺ve  | 垵ve  | 隌ve  | 碪ve  | 
ao | 奥   | 澳   | 熬   | 傲   | ┗|｀O′|┛ 嗷~~   | 嗷   | 凹   | 敖   | 袄   | 坳   | 鳌   | 拗   | 獒   | 啊哦   | 岙   | 翱   | 
aou | 啊偶   | 啊偶  | 阿偶  | 吖偶  | 嗄偶  | 锕偶  | 呵偶  | 腌偶  | 錒偶  | 鷔u  | 镺u  | 厫u  | 嶴u  | 獓u  | 嗸u  | 墺u  | 
apa | 阿帕   | 安帕   | 俺怕   | 啊啪   | 啊怕  | 哎怕  | 阿怕  | 爱怕  | 按怕  | 唉怕  | 安怕  | 俺怕  | 奥怕  | 案怕  | 吖怕  | 艾怕  | 
apai | 安排   | 爱拍   | 奥派   | 暗拍   | 爱派   | 啊拍  | 哎拍  | 阿拍  | 爱拍  | 按拍  | 唉拍  | 安拍  | 俺拍  | 奥拍  | 案拍  | 吖拍  | 
apan | A盘   | 阿潘   | 澳盘   | 暗盘   | 啊盘  | 哎盘  | 阿盘  | 爱盘  | 按盘  | 唉盘  | 安盘  | 俺盘  | 奥盘  | 案盘  | 吖盘  | 艾盘  | 
apang | 奥胖   | 矮胖   | 阿胖   | 癌旁   | 安胖   | 阿庞   | 啊胖  | 哎胖  | 阿胖  | 爱胖  | 按胖  | 唉胖  | 安胖  | 俺胖  | 奥胖  | 案胖  | 
apao | 爱跑   | 岸炮   | 挨炮   | 阿帕哦  | 安帕哦  | 俺怕哦  | 啊啪哦  | 啊跑  | 哎跑  | 阿跑  | 爱跑  | 按跑  | 唉跑  | 安跑  | 俺跑  | 奥跑  | 
apei | 啊呸   | 安培   | 阿沛   | 暗配   | 啊配  | 哎配  | 阿配  | 爱配  | 按配  | 唉配  | 安配  | 俺配  | 奥配  | 案配  | 吖配  | 艾配  | 
apen | 挨喷   | 啊喷  | 哎喷  | 阿喷  | 爱喷  | 按喷  | 唉喷  | 安喷  | 俺喷  | 奥喷  | 案喷  | 吖喷  | 艾喷  | 昂喷  | 埃喷  | 暗喷  | 
apeng | 奥鹏   | 阿鹏   | 艾蓬   | 安鹏   | 阿彭   | 艾鹏   | 啊彭  | 哎彭  | 阿彭  | 爱彭  | 按彭  | 唉彭  | 安彭  | 俺彭  | 奥彭  | 案彭  | 
api | 挨批   | 阿皮   | 啊屁   | 暗批   | 阿屁   | 啊皮  | 哎皮  | 阿皮  | 爱皮  | 按皮  | 唉皮  | 安皮  | 俺皮  | 奥皮  | 案皮  | 吖皮  | 
apian | A片   | 阿片   | 挨批按  | 阿皮按  | 啊屁按  | 暗批按  | 阿屁按  | 啊篇  | 哎篇  | 阿篇  | 爱篇  | 按篇  | 唉篇  | 安篇  | 俺篇  | 奥篇  | 
apiao | 暗票   | 阿飘   | 啊飘   | 啊票   | 挨批奥  | 阿皮奥  | 啊屁奥  | 暗批奥  | 阿屁奥  | 啊票  | 哎票  | 阿票  | 爱票  | 按票  | 唉票  | 安票  | 
apie | apiece   | 挨批二  | 阿皮二  | 啊屁二  | 暗批二  | 阿屁二  | 啊撇  | 哎撇  | 阿撇  | 爱撇  | 按撇  | 唉撇  | 安撇  | 俺撇  | 奥撇  | 案撇  | 
apin | 爱拼   | 安贫   | 安品   | 啊品  | 哎品  | 阿品  | 爱品  | 按品  | 唉品  | 安品  | 俺品  | 奥品  | 案品  | 吖品  | 艾品  | 昂品  | 
aping | 安平   | 阿平   | 爱平   | 安瓶   | 爱萍   | 安评   | 昂坪   | 阿萍   | 啊平  | 哎平  | 阿平  | 爱平  | 按平  | 唉平  | 安平  | 俺平  | 
apo | 阿婆   | 安珀   | 岸坡   | 奥珀   | 啊破  | 哎破  | 阿破  | 爱破  | 按破  | 唉破  | 安破  | 俺破  | 奥破  | 案破  | 吖破  | 艾破  | 
apou | 阿剖   | 啊剖  | 哎剖  | 阿剖  | 爱剖  | 按剖  | 唉剖  | 安剖  | 俺剖  | 奥剖  | 案剖  | 吖剖  | 艾剖  | 昂剖  | 埃剖  | 暗剖  | 
apu | 阿普   | 安普   | 爱普   | 奥普   | 艾普   | 啊噗   | 阿噗   | 安谱   | 安铺   | 啊普  | 哎普  | 阿普  | 爱普  | 按普  | 唉普  | 安普  | 
aqi | 暗器   | 安琪   | 按期   | 爱妻   | 傲气   | 按其   | 阿奇   | 阿七   | 氨气   | 安琦   | 艾奇   | 安奇   | 奥奇   | 艾琪   | 嗳气   | 阿琪   | 
aqia | 奥恰   | 暗器啊  | 安琪啊  | 按期啊  | 爱妻啊  | 傲气啊  | 按其啊  | 阿奇啊  | 阿七啊  | 氨气啊  | 安琦啊  | 艾奇啊  | 安奇啊  | 奥奇啊  | 艾琪啊  | 嗳气啊  | 
aqian | 爱钱   | 啊钱   | 安茜   | 癌前   | 阿钱   | 按钱   | 阿谦   | 澳签   | 暗器按  | 安琪按  | 按期按  | 爱妻按  | 傲气按  | 按其按  | 阿奇按  | 阿七按  | 
aqiang | 阿强   | 矮墙   | 爱墙   | 暗强   | 奥强   | 暗枪   | 暗器昂  | 安琪昂  | 按期昂  | 爱妻昂  | 傲气昂  | 按其昂  | 阿奇昂  | 阿七昂  | 氨气昂  | 安琦昂  | 
aqiao | 安桥   | 阿悄   | 岸桥   | 爱桥   | 埃奇奥   | 暗器奥  | 安琪奥  | 按期奥  | 爱妻奥  | 傲气奥  | 按其奥  | 阿奇奥  | 阿七奥  | 氨气奥  | 安琦奥  | 艾奇奥  | 
aqie | 啊企鹅   | 啊切   | 哀切   | 安且   | 暗器二  | 安琪二  | 按期二  | 爱妻二  | 傲气二  | 按其二  | 阿奇二  | 阿七二  | 氨气二  | 安琦二  | 艾奇二  | 安奇二  | 
aqin | 爱琴   | 阿沁   | 阿琴   | 安寝   | 爱亲   | 安亲   | 阿钦   | 爱情   | 啊亲  | 哎亲  | 阿亲  | 爱亲  | 按亲  | 唉亲  | 安亲  | 俺亲  | 
aqing | 爱情   | 安庆   | 案情   | 爱卿   | 阿庆   | 艾青   | 阿清   | 阿青   | 傲晴   | 安晴   | 爱清   | 啊请  | 哎请  | 阿请  | 爱请  | 按请  | 
aqiong | 阿琼   | 啊穷  | 哎穷  | 阿穷  | 爱穷  | 按穷  | 唉穷  | 安穷  | 俺穷  | 奥穷  | 案穷  | 吖穷  | 艾穷  | 昂穷  | 埃穷  | 暗穷  | 
aqiu | 哀求   | 安丘   | 阿秋   | 阿丘   | 挨球   | 爱囚   | 暗球   | 奥球   | 奥求   | 啊求  | 哎求  | 阿求  | 爱求  | 按求  | 唉求  | 安求  | 
aqu | 啊去   | 爱去   | 俺去   | 暗区   | 暗渠   | 安趣   | 氨区   | 奥区   | 爱趣   | 啊去  | 哎去  | 阿去  | 爱去  | 按去  | 唉去  | 安去  | 
aquan | 安全   | 敖犬   | 爱犬   | 阿全   | 啊全   | 阿泉   | 阿权   | 安泉   | 啊去按  | 爱去按  | 俺去按  | 暗区按  | 暗渠按  | 安趣按  | 氨区按  | 奥区按  | 
aque | 阿缺   | aqueduct   | 啊去二  | 爱去二  | 俺去二  | 暗区二  | 暗渠二  | 安趣二  | 氨区二  | 奥区二  | 爱趣二  | 啊却  | 哎却  | 阿却  | 爱却  | 按却  | 
aqun | 爱群   | 阿群   | 袄裙   | 按群   | 啊群  | 哎群  | 阿群  | 爱群  | 按群  | 唉群  | 安群  | 俺群  | 奥群  | 案群  | 吖群  | 艾群  | 
aran | 安然   | 黯然   | 盎然   | 傲然   | 昂然   | 阿然   | 安冉   | 岸然   | 蔼然   | Aran   | 啊然  | 哎然  | 阿然  | 爱然  | 按然  | 唉然  | 
arang | 啊让   | 爱让   | 阿让   | 啊让  | 哎让  | 阿让  | 爱让  | 按让  | 唉让  | 安让  | 俺让  | 奥让  | 案让  | 吖让  | 艾让  | 昂让  | 
arao | 啊绕   | 安然哦  | 黯然哦  | 啊让哦  | 盎然哦  | 傲然哦  | 昂然哦  | 爱让哦  | 阿然哦  | 安冉哦  | 岸然哦  | 蔼然哦  | 阿让哦  | 啊绕  | 哎绕  | 阿绕  | 
are | 啊热   | 昂热   | 哎惹   | 啊热  | 哎热  | 阿热  | 爱热  | 按热  | 唉热  | 安热  | 俺热  | 奥热  | 案热  | 吖热  | 艾热  | 昂热  | 
aren | 爱人   | 矮人   | 安人   | 傲人   | 安仁   | 阿仁   | 熬人   | 按人   | 昂仁   | 奥刃   | arena   | 啊人  | 哎人  | 阿人  | 爱人  | 按人  | 
areng | 啊仍   | 爱人   | 啊仍  | 哎仍  | 阿仍  | 爱仍  | 按仍  | 唉仍  | 安仍  | 俺仍  | 奥仍  | 案仍  | 吖仍  | 艾仍  | 昂仍  | 埃仍  | 
ari | 按日   | 奥日   | 啊日  | 哎日  | 阿日  | 爱日  | 按日  | 唉日  | 安日  | 俺日  | 奥日  | 案日  | 吖日  | 艾日  | 昂日  | 埃日  | 
arong | 阿荣   | 艾绒   | 阿容   | 哀荣   | 安荣   | 暗荣   | 啊容  | 哎容  | 阿容  | 爱容  | 按容  | 唉容  | 安容  | 俺容  | 奥容  | 案容  | 
arou | 按揉   | 爱柔   | around   | 啊肉  | 哎肉  | 阿肉  | 爱肉  | 按肉  | 唉肉  | 安肉  | 俺肉  | 奥肉  | 案肉  | 吖肉  | 艾肉  | 昂肉  | 
aru | 爱如   | 凹入   | 安如   | 艾如   | 啊如  | 哎如  | 阿如  | 爱如  | 按如  | 唉如  | 安如  | 俺如  | 奥如  | 案如  | 吖如  | 艾如  | 
arua | 爱如啊   | 爱如啊  | 凹入啊  | 安如啊  | 艾如啊  | 啊挼  | 哎挼  | 阿挼  | 爱挼  | 按挼  | 唉挼  | 安挼  | 俺挼  | 奥挼  | 案挼  | 吖挼  | 
aruan | 阿阮   | 爱如按  | 凹入按  | 安如按  | 艾如按  | 啊软  | 哎软  | 阿软  | 爱软  | 按软  | 唉软  | 安软  | 俺软  | 奥软  | 案软  | 吖软  | 
arui | 艾瑞   | 阿瑞   | 安瑞   | 奥瑞   | 艾睿   | 阿睿   | 安睿   | 啊瑞  | 哎瑞  | 阿瑞  | 爱瑞  | 按瑞  | 唉瑞  | 安瑞  | 俺瑞  | 奥瑞  | 
arun | 安润   | 奥润   | 啊润  | 哎润  | 阿润  | 爱润  | 按润  | 唉润  | 安润  | 俺润  | 奥润  | 案润  | 吖润  | 艾润  | 昂润  | 埃润  | 
aruo | 阿若   | 爱若   | 暗弱   | 爱如哦  | 凹入哦  | 安如哦  | 艾如哦  | 啊若  | 哎若  | 阿若  | 爱若  | 按若  | 唉若  | 安若  | 俺若  | 奥若  | 
asa | 阿萨   | 奥萨   | 艾萨   | 俺仨   | 啊撒  | 哎撒  | 阿撒  | 爱撒  | 按撒  | 唉撒  | 安撒  | 俺撒  | 奥撒  | 案撒  | 吖撒  | 艾撒  | 
asai | 奥赛   | 埃塞   | 安塞   | 啊赛  | 哎赛  | 阿赛  | 爱赛  | 按赛  | 唉赛  | 安赛  | 俺赛  | 奥赛  | 案赛  | 吖赛  | 艾赛  | 昂赛  | 
asan | 阿三   | 艾散   | 安三   | 昂三   | Asante   | 啊三  | 哎三  | 阿三  | 爱三  | 按三  | 唉三  | 安三  | 俺三  | 奥三  | 案三  | 吖三  | 
asang | 阿桑   | 懊丧   | 啊桑  | 哎桑  | 阿桑  | 爱桑  | 按桑  | 唉桑  | 安桑  | 俺桑  | 奥桑  | 案桑  | 吖桑  | 艾桑  | 昂桑  | 埃桑  | 
asao | 阿嫂   | 阿萨哦  | 奥萨哦  | 艾萨哦  | 俺仨哦  | 啊扫  | 哎扫  | 阿扫  | 爱扫  | 按扫  | 唉扫  | 安扫  | 俺扫  | 奥扫  | 案扫  | 吖扫  | 
ase | 阿瑟   | 暗色   | 爱色   | 阿色   | 安瑟   | 奥瑟   | 啊色  | 哎色  | 阿色  | 爱色  | 按色  | 唉色  | 安色  | 俺色  | 奥色  | 案色  | 
asen | 艾森   | 阿森   | 奥森   | 埃森   | 爱森   | 安森   | 啊森  | 哎森  | 阿森  | 爱森  | 按森  | 唉森  | 安森  | 俺森  | 奥森  | 案森  | 
aseng | 阿僧   | 安生   | 啊僧  | 哎僧  | 阿僧  | 爱僧  | 按僧  | 唉僧  | 安僧  | 俺僧  | 奥僧  | 案僧  | 吖僧  | 艾僧  | 昂僧  | 埃僧  | 
asha | 暗杀   | 阿莎   | 艾莎   | 暗沙   | 啊啥   | 爱莎   | 阿沙   | 爱杀   | 安沙   | 按啥   | 哎啥   | ashamed   | 啊啥  | 哎啥  | 阿啥  | 爱啥  | 
ashai | 挨晒   | 啊晒  | 哎晒  | 阿晒  | 爱晒  | 按晒  | 唉晒  | 安晒  | 俺晒  | 奥晒  | 案晒  | 吖晒  | 艾晒  | 昂晒  | 埃晒  | 暗晒  | 
ashan | 鞍山   | 阿山   | 安山   | 奥山   | 鳌山   | 昂山   | 爱山   | 艾山   | 阿珊   | Ashanti   | 啊山  | 哎山  | 阿山  | 爱山  | 按山  | 唉山  | 
ashang | 爱上   | 哀伤   | 岸上   | 安上   | 爱尚   | 按上   | 暗伤   | 啊上   | 挨上   | 熬上   | 艾尚   | 暗殇   | 爱殇   | 阿上   | 啊上  | 哎上  | 
ashao | 暗哨   | 安少   | 暗杀哦  | 阿莎哦  | 艾莎哦  | 暗沙哦  | 啊啥哦  | 爱莎哦  | 阿沙哦  | 爱杀哦  | 安沙哦  | 按啥哦  | 哎啥哦  | 啊少  | 哎少  | 阿少  | 
ashe | 阿佘   | 案涉   | 安设   | 爱舍   | 爱射   | 暗射   | ashes   | 啊设  | 哎设  | 阿设  | 爱设  | 按设  | 唉设  | 安设  | 俺设  | 奥设  | 
ashei | 爱谁   | 啊谁  | 哎谁  | 阿谁  | 爱谁  | 按谁  | 唉谁  | 安谁  | 俺谁  | 奥谁  | 案谁  | 吖谁  | 艾谁  | 昂谁  | 埃谁  | 暗谁  | 
ashen | 爱神   | 安神   | 安身   | 阿婶   | 奥神   | 阿神   | 埃神   | 阿沈   | 阿屾   | 奥深   | ashen   | 啊神  | 哎神  | 阿神  | 爱神  | 按神  | 
asheng | 安生   | 安省   | 安盛   | 爱生   | 阿生   | 哀声   | 阿胜   | 安胜   | 安笙   | 阿笙   | 唉声   | 傲胜   | 奥盛   | 啊生  | 哎生  | 阿生  | 
ashi | 按时   | 暗示   | 啊是   | 爱是   | 俺是   | 阿什   | 碍事   | 傲视   | 傲世   | 安市   | 阿是   | 暗室   | 安适   | 安氏   | 安室   | 按实   | 
ashou | 昂首   | 安守   | 按手   | 碍手   | 奥手   | 奥受   | 啊收  | 哎收  | 阿收  | 爱收  | 按收  | 唉收  | 安收  | 俺收  | 奥收  | 案收  | 
ashu | 奥数   | 阿叔   | 桉树   | 奥术   | 爱书   | 阿树   | 谙熟   | 安叔   | 爱数   | 俺叔   | 艾数   | 啊书  | 哎书  | 阿书  | 爱书  | 按书  | 
ashua | 爱耍   | 暗刷   | 奥数啊  | 阿叔啊  | 桉树啊  | 奥术啊  | 爱书啊  | 阿树啊  | 谙熟啊  | 安叔啊  | 爱数啊  | 俺叔啊  | 艾数啊  | 啊刷  | 哎刷  | 阿刷  | 
ashuai | 阿帅   | 安帅   | 阿衰   | 奥帅   | 奥数哎  | 阿叔哎  | 桉树哎  | 奥术哎  | 爱书哎  | 阿树哎  | 谙熟哎  | 安叔哎  | 爱数哎  | 俺叔哎  | 艾数哎  | 啊帅  | 
ashuan | 癌栓   | 奥数按  | 阿叔按  | 桉树按  | 奥术按  | 爱书按  | 阿树按  | 谙熟按  | 安叔按  | 爱数按  | 俺叔按  | 艾数按  | 啊栓  | 哎栓  | 阿栓  | 爱栓  | 
ashuang | 暗爽   | 傲霜   | 啊爽   | 阿爽   | 奥数昂  | 阿叔昂  | 桉树昂  | 奥术昂  | 爱书昂  | 阿树昂  | 谙熟昂  | 安叔昂  | 爱数昂  | 俺叔昂  | 艾数昂  | 啊双  | 
ashui | 爱谁   | 安睡   | 氨水   | 阿水   | 爱睡   | 啊谁   | 爱水   | 熬水   | 奥水   | 啊谁  | 哎谁  | 阿谁  | 爱谁  | 按谁  | 唉谁  | 安谁  | 
ashun | 安顺   | 阿顺   | 啊顺  | 哎顺  | 阿顺  | 爱顺  | 按顺  | 唉顺  | 安顺  | 俺顺  | 奥顺  | 案顺  | 吖顺  | 艾顺  | 昂顺  | 埃顺  | 
ashuo | 按说   | 爱说   | 俺说   | 挨说   | 安硕   | 奥数哦  | 阿叔哦  | 桉树哦  | 奥术哦  | 爱书哦  | 阿树哦  | 谙熟哦  | 安叔哦  | 爱数哦  | 俺叔哦  | 艾数哦  | 
asi | 阿斯   | 奥斯   | 埃斯   | 爱死   | 艾斯   | 盎司   | 阿四   | 爱思   | 哀思   | 安斯   | 爱丝   | 艾思   | 熬死   | 按死   | 阿肆   | 奥司   | 
asong | 阿松   | 傲松   | 暗送   | 安松   | 啊送  | 哎送  | 阿送  | 爱送  | 按送  | 唉送  | 安送  | 俺送  | 奥送  | 案送  | 吖送  | 艾送  | 
asou | 啊搜   | 啊搜  | 哎搜  | 阿搜  | 爱搜  | 按搜  | 唉搜  | 安搜  | 俺搜  | 奥搜  | 案搜  | 吖搜  | 艾搜  | 昂搜  | 埃搜  | 暗搜  | 
asu | 阿苏   | 安苏   | 奥苏   | 安素   | 哀诉   | 艾素   | 啊苏  | 哎苏  | 阿苏  | 爱苏  | 按苏  | 唉苏  | 安苏  | 俺苏  | 奥苏  | 案苏  | 
asuan | 暗算   | 氨酸   | 啊算   | 嗳酸   | 阿苏按  | 安苏按  | 奥苏按  | 安素按  | 哀诉按  | 艾素按  | 啊算  | 哎算  | 阿算  | 爱算  | 按算  | 唉算  | 
asui | 安随   | 啊随  | 哎随  | 阿随  | 爱随  | 按随  | 唉随  | 安随  | 俺随  | 奥随  | 案随  | 吖随  | 艾随  | 昂随  | 埃随  | 暗随  | 
asun | Asuncion   | 安顺   | 啊孙  | 哎孙  | 阿孙  | 爱孙  | 按孙  | 唉孙  | 安孙  | 俺孙  | 奥孙  | 案孙  | 吖孙  | 艾孙  | 昂孙  | 埃孙  | 
asuo | 阿索   | 埃索   | 安索   | 安所   | 爱索   | 暗锁   | 阿苏哦  | 安苏哦  | 奥苏哦  | 安素哦  | 哀诉哦  | 艾素哦  | 啊所  | 哎所  | 阿所  | 爱所  | 
ata | 爱他   | 爱她   | 安踏   | 阿塔   | 爱它   | 埃塔   | 按他   | 奥塔   | 按她   | 啊他  | 哎他  | 阿他  | 爱他  | 按他  | 唉他  | 安他  | 
atai | 阿泰   | 安泰   | 安胎   | 奥泰   | 阿太   | 案台   | 艾泰   | 暗态   | 埃泰   | 啊太  | 哎太  | 阿太  | 爱太  | 按太  | 唉太  | 安太  | 
atan | 哀叹   | 暗叹   | 暗探   | 艾坦   | 暗滩   | 啊谈  | 哎谈  | 阿谈  | 爱谈  | 按谈  | 唉谈  | 安谈  | 俺谈  | 奥谈  | 案谈  | 吖谈  | 
atang | 熬汤   | 阿汤   | 庵堂   | 氨糖   | 安堂   | 阿唐   | 啊唐  | 哎唐  | 阿唐  | 爱唐  | 按唐  | 唉唐  | 安唐  | 俺唐  | 奥唐  | 案唐  | 
atao | 阿涛   | 阿桃   | 爱淘   | 安涛   | 爱涛   | 阿滔   | 爱他哦  | 爱她哦  | 安踏哦  | 阿塔哦  | 爱它哦  | 埃塔哦  | 按他哦  | 奥塔哦  | 按她哦  | 啊套  | 
ate | 艾特   | 奥特   | 阿特   | 安特   | 埃特   | 爱特   | 翱特   | 啊特  | 哎特  | 阿特  | 爱特  | 按特  | 唉特  | 安特  | 俺特  | 奥特  | 
atei | 啊忒   | 啊忒  | 哎忒  | 阿忒  | 爱忒  | 按忒  | 唉忒  | 安忒  | 俺忒  | 奥忒  | 案忒  | 吖忒  | 艾忒  | 昂忒  | 埃忒  | 暗忒  | 
ateng | 安藤   | 安腾   | 阿腾   | 傲腾   | 奥腾   | 啊疼  | 哎疼  | 阿疼  | 爱疼  | 按疼  | 唉疼  | 安疼  | 俺疼  | 奥疼  | 案疼  | 吖疼  | 
ati | 安提   | 奥体   | 挨踢   | 阿嚏   | 安替   | 哀啼   | 凹体   | 啊提  | 哎提  | 阿提  | 爱提  | 按提  | 唉提  | 安提  | 俺提  | 奥提  | 
atian | 傲天   | 按天   | 安田   | 阿天   | 安恬   | 暗天   | 爱田   | 安天   | 岸田   | 奥田   | 阿田   | 敖天   | 安提按  | 奥体按  | 挨踢按  | 阿嚏按  | 
atiao | 艾条   | 安调   | 按条   | 暗调   | 安提奥  | 奥体奥  | 挨踢奥  | 阿嚏奥  | 安替奥  | 哀啼奥  | 凹体奥  | 啊条  | 哎条  | 阿条  | 爱条  | 按条  | 
atie | 安铁   | 安提二  | 奥体二  | 挨踢二  | 阿嚏二  | 安替二  | 哀啼二  | 凹体二  | 啊贴  | 哎贴  | 阿贴  | 爱贴  | 按贴  | 唉贴  | 安贴  | 俺贴  | 
ating | 爱听   | 安亭   | 阿婷   | 安婷   | 安汀   | 啊听  | 哎听  | 阿听  | 爱听  | 按听  | 唉听  | 安听  | 俺听  | 奥听  | 案听  | 吖听  | 
atong | 哀痛   | 安通   | 奥通   | 哀恸   | 阿通   | 癌痛   | 澳通   | 啊同  | 哎同  | 阿同  | 爱同  | 按同  | 唉同  | 安同  | 俺同  | 奥同  | 
atou | 案头   | 鳌头   | 昂头   | 澳头   | 按头   | 啊头  | 哎头  | 阿头  | 爱头  | 按头  | 唉头  | 安头  | 俺头  | 奥头  | 案头  | 吖头  | 
atu | 凹凸   | 安图   | 爱徒   | 按图   | 阿土   | 奥图   | 阿图   | 安途   | 凹土   | 啊图  | 哎图  | 阿图  | 爱图  | 按图  | 唉图  | 安图  | 
atuan | 安团   | 爱团   | 暗团   | 凹凸按  | 安图按  | 爱徒按  | 按图按  | 阿土按  | 奥图按  | 阿图按  | 安途按  | 凹土按  | 啊团  | 哎团  | 阿团  | 爱团  | 
atui | 暗推   | 啊退  | 哎退  | 阿退  | 爱退  | 按退  | 唉退  | 安退  | 俺退  | 奥退  | 案退  | 吖退  | 艾退  | 昂退  | 埃退  | 暗退  | 
atun | 安屯   | 按屯   | 啊屯  | 哎屯  | 阿屯  | 爱屯  | 按屯  | 唉屯  | 安屯  | 俺屯  | 奥屯  | 案屯  | 吖屯  | 艾屯  | 昂屯  | 埃屯  | 
atuo | 奥托   | 奥拓   | 安托   | 安妥   | 阿托   | 安拓   | 艾拓   | 凹凸哦  | 安图哦  | 爱徒哦  | 按图哦  | 阿土哦  | 奥图哦  | 阿图哦  | 安途哦  | 凹土哦  | 
awa | 阿瓦   | 暗挖   | 爱娃   | 艾娃   | 奥瓦   | 爱瓦   | 暗瓦   | 爱蛙   | 安娃   | 哎哇   | 啊哇  | 哎哇  | 阿哇  | 爱哇  | 按哇  | 唉哇  | 
awai | 安外   | 案外   | awaiting   | 啊外  | 哎外  | 阿外  | 爱外  | 按外  | 唉外  | 安外  | 俺外  | 奥外  | 案外  | 吖外  | 艾外  | 昂外  | 
awan | 爱玩   | 哀婉   | 按完   | 熬完   | 安完   | 吖玩   | 阿万   | 啊玩  | 哎玩  | 阿玩  | 爱玩  | 按玩  | 唉玩  | 安玩  | 俺玩  | 奥玩  | 
awang | 澳网   | 阿旺   | 暗网   | 安网   | 阿汪   | 阿王   | 奥王   | 啊王  | 哎王  | 阿王  | 爱王  | 按王  | 唉王  | 安王  | 俺王  | 奥王  | 
awei | 安慰   | 安危   | 阿伟   | 阿威   | 啊喂   | 阿维   | 奥维   | 艾薇   | 按位   | 艾维   | 暗卫   | 阿魏   | 艾威   | 爱为   | 爱维   | 奥威   | 
awen | 阿文   | 安稳   | 爱问   | 艾文   | 埃文   | 暗纹   | 安文   | 爱文   | 奥文   | 阿雯   | 埃温   | 啊问  | 哎问  | 阿问  | 爱问  | 按问  | 
aweng | 阿翁   | 艾翁   | 阿文   | 啊翁  | 哎翁  | 阿翁  | 爱翁  | 按翁  | 唉翁  | 安翁  | 俺翁  | 奥翁  | 案翁  | 吖翁  | 艾翁  | 昂翁  | 
awo | 啊我   | 爱我   | 按我   | 哎我   | 奥沃   | 昂我   | 挨我   | 安卧   | 啊我  | 哎我  | 阿我  | 爱我  | 按我  | 唉我  | 安我  | 俺我  | 
awong | 啊Wong   | 啊我能给  | 啊我那个  | 爱我那个  | 按我那个  | 哎我那个  | 奥沃那个  | 昂我那个  | 挨我那个  | 安卧那个  | 啊我那个  | 哎我那个  | 阿我那个  | 爱我那个  | 按我那个  | 唉我那个  | 
awu | 啊呜   | 嗷呜   | 阿武   | 暗巫   | 爱屋   | 爱物   | 傲物   | 阿五   | 爱吾   | 嗷唔   | 阿巫   | 阿无   | 啊五  | 哎五  | 阿五  | 爱五  | 
axi | 爱惜   | 安息   | 安溪   | 阿西   | 安西   | 艾希   | 阿希   | 埃希   | 暗喜   | 阿喜   | 奥西   | 艾西   | 爱喜   | 暗系   | 阿细   | 哎西   | 
axia | 按下   | 阿霞   | 安下   | 阿夏   | 暗下   | 爱霞   | 凹下   | 安夏   | 爱夏   | 鳌虾   | 暗侠   | axial   | 爱惜啊  | 安息啊  | 安溪啊  | 阿西啊  | 
axian | 安县   | 凹陷   | 岸线   | 暗线   | 安闲   | 氨酰   | 爱现   | 按弦   | 阿贤   | 安线   | 爱惜按  | 安息按  | 安溪按  | 阿西按  | 安西按  | 艾希按  | 
axiang | 安详   | 翱翔   | 暗香   | 啊想   | 暗想   | 阿香   | 安乡   | 安祥   | 暗箱   | 俺想   | 安享   | 阿翔   | 阿祥   | 爱香   | 奥翔   | 爱想   | 
axiao | 爱笑   | 矮小   | 啊小   | 暗笑   | 爱校   | 暗销   | 阿孝   | 奥校   | 阿笑   | 阿肖   | 阿小   | 按下哦  | 阿霞哦  | 安下哦  | 阿夏哦  | 暗下哦  | 
axie | 安歇   | 奥谢   | 爱写   | 傲血   | 爱惜二  | 安息二  | 安溪二  | 阿西二  | 安西二  | 艾希二  | 阿希二  | 埃希二  | 暗喜二  | 阿喜二  | 奥西二  | 艾西二  | 
axin | 爱心   | 安心   | 阿信   | 安信   | 澳新   | 埃辛   | 爱信   | 安新   | 阿新   | 阿欣   | 熬心   | 阿鑫   | 爱新   | 阿辛   | 安欣   | 安鑫   | 
axing | 阿星   | 矮星   | 安兴   | 暗星   | 凹形   | 奥星   | 阿兴   | 澳星   | 癌性   | 安行   | 澳兴   | 啊行  | 哎行  | 阿行  | 爱行  | 按行  | 
axiong | 阿雄   | 奥匈   | 阿熊   | 挨熊   | 啊熊  | 哎熊  | 阿熊  | 爱熊  | 按熊  | 唉熊  | 安熊  | 俺熊  | 奥熊  | 案熊  | 吖熊  | 艾熊  | 
axiu | 阿秀   | 阿修   | 爱秀   | 奥修   | 啊修  | 哎修  | 阿修  | 爱修  | 按修  | 唉修  | 安修  | 俺修  | 奥修  | 案修  | 吖修  | 艾修  | 
axu | 按需   | 按序   | 阿旭   | 阿虚   | 安旭   | 安许   | 爱旭   | 啊徐  | 哎徐  | 阿徐  | 爱徐  | 按徐  | 唉徐  | 安徐  | 俺徐  | 奥徐  | 
axuan | 阿轩   | 按需按  | 按序按  | 阿旭按  | 阿虚按  | 安旭按  | 安许按  | 爱旭按  | 啊选  | 哎选  | 阿选  | 爱选  | 按选  | 唉选  | 安选  | 俺选  | 
axue | 阿雪   | 傲雪   | 爱学   | 爱雪   | 艾雪   | 暗血   | 安雪   | 傲血   | 澳雪   | 按需二  | 按序二  | 阿旭二  | 阿虚二  | 安旭二  | 安许二  | 爱旭二  | 
axun | 挨训   | 安迅   | 奥逊   | 啊寻  | 哎寻  | 阿寻  | 爱寻  | 按寻  | 唉寻  | 安寻  | 俺寻  | 奥寻  | 案寻  | 吖寻  | 艾寻  | 昂寻  | 
aya | 哎呀   | 啊呀   | 按压   | 唉呀   | 阿雅   | 安雅   | 爱呀   | 阿亚   | 奥雅   | 暗哑   | 艾雅   | 爱雅   | 澳亚   | 奥亚   | 爱牙   | 暗鸦   | 
ayan | 碍眼   | 阿焰   | 铵盐   | 阿燕   | 爱眼   | 阿言   | 阿宴   | 哀艳   | 安言   | 啊眼  | 哎眼  | 阿眼  | 爱眼  | 按眼  | 唉眼  | 安眼  | 
ayang | 安阳   | 昂扬   | 阿阳   | 澳洋   | 安扬   | 安洋   | 阿洋   | 爱养   | 阿杨   | 按样   | 啊杨  | 哎杨  | 阿杨  | 爱杨  | 按杨  | 唉杨  | 
ayao | 爱要   | 俺要   | 熬药   | 哎吆   | 啊要   | 阿瑶   | 阿耀   | 阿尧   | 哎呀哦  | 啊呀哦  | 按压哦  | 唉呀哦  | 阿雅哦  | 安雅哦  | 爱呀哦  | 阿亚哦  | 
aye | 熬夜   | 暗夜   | 俺也   | 艾叶   | 阿爷   | 阿夜   | 阿叶   | 爱液   | 安业   | 俺爷   | 胺液   | 阿耶   | 啊也  | 哎也  | 阿也  | 爱也  | 
ayi | 阿姨   | 安逸   | 爱意   | 奥义   | 阿伊   | 阿忆   | 阿依   | 阿一   | 安邑   | 安义   | 安一   | 安怡   | 安医   | 安易   | 暗翼   | 安宜   | 
ayin | 艾因   | 阿银   | 爱因   | 凹印   | 阿音   | 澳银   | 爱音   | 暗隐   | 拗音   | 啊因  | 哎因  | 阿因  | 爱因  | 按因  | 唉因  | 安因  | 
aying | 暗影   | 阿英   | 安营   | 爱婴   | 爱英   | 阿影   | 安颖   | 阿莹   | 阿颖   | 安盈   | 安赢   | 奥英   | 爱盈   | 啊应  | 哎应  | 阿应  | 
ayo | 哎哟   | 啊哟   | 唉哟   | 哎唷   | 奥哟   | 嗷哟   | 啊哟  | 哎哟  | 阿哟  | 爱哟  | 按哟  | 唉哟  | 安哟  | 俺哟  | 奥哟  | 案哟  | 
ayong | 安永   | 爱用   | 暗涌   | 阿勇   | 安勇   | 艾勇   | 啊用  | 哎用  | 阿用  | 爱用  | 按用  | 唉用  | 安用  | 俺用  | 奥用  | 案用  | 
ayou | 哎呦   | 遨游   | 傲游   | 矮油   | 案由   | 阿尤   | 啊有   | 爱有   | 俺有   | 爱幼   | 澳优   | 安佑   | 啊呦   | 熬油   | 阿友   | 爱游   | 
ayu | 爱与   | 碍于   | 安于   | 暗语   | 暗喻   | 阿玉   | 爱欲   | 按语   | 阿语   | 阿宇   | 爱玉   | 爱语   | 安宇   | 傲宇   | 阿鱼   | 鳌鱼   | 
ayuan | 澳元   | 哀怨   | 爱媛   | 安源   | 奥园   | 安远   | 安元   | 案源   | 阿源   | 阿远   | 安苑   | 阿圆   | 奥援   | 爱源   | 阿媛   | 奥源   | 
ayue | 按月   | 爱乐   | 暗月   | 哀乐   | 安岳   | 傲月   | 阿月   | 阿越   | 安悦   | 阿岳   | 按约   | 安越   | 爱与二  | 碍于二  | 安于二  | 暗语二  | 
ayun | 奥运   | 阿云   | 爱云   | 艾云   | 安云   | 暗云   | 安运   | 啊云  | 哎云  | 阿云  | 爱云  | 按云  | 唉云  | 安云  | 俺云  | 奥云  | 
aza | 腌臜   | 啊咋   | 爱咋   | 啊咋  | 哎咋  | 阿咋  | 爱咋  | 按咋  | 唉咋  | 安咋  | 俺咋  | 奥咋  | 案咋  | 吖咋  | 艾咋  | 昂咋  | 
azai | 爱在   | 安在   | 俺在   | 按在   | 啊在   | 哀哉   | 挨宰   | 安仔   | 挨在   | 啊在  | 哎在  | 阿在  | 爱在  | 按在  | 唉在  | 安在  | 
azan | 阿赞   | 按赞   | 奥赞   | 啊赞  | 哎赞  | 阿赞  | 爱赞  | 按赞  | 唉赞  | 安赞  | 俺赞  | 奥赞  | 案赞  | 吖赞  | 艾赞  | 昂赞  | 
azang | 肮脏   | 安葬   | 啊藏  | 哎藏  | 阿藏  | 爱藏  | 按藏  | 唉藏  | 安藏  | 俺藏  | 奥藏  | 案藏  | 吖藏  | 艾藏  | 昂藏  | 埃藏  | 
azao | 俺早   | 凹糟   | 按照   | 腌臜哦  | 啊咋哦  | 爱咋哦  | 啊早  | 哎早  | 阿早  | 爱早  | 按早  | 唉早  | 安早  | 俺早  | 奥早  | 案早  | 
aze | 阿泽   | 安泽   | 奥泽   | 艾泽   | 啊则  | 哎则  | 阿则  | 爱则  | 按则  | 唉则  | 安则  | 俺则  | 奥则  | 案则  | 吖则  | 艾则  | 
azei | 啊贼   | 啊贼  | 哎贼  | 阿贼  | 爱贼  | 按贼  | 唉贼  | 安贼  | 俺贼  | 奥贼  | 案贼  | 吖贼  | 艾贼  | 昂贼  | 埃贼  | 暗贼  | 
azen | 啊怎   | 啊怎  | 哎怎  | 阿怎  | 爱怎  | 按怎  | 唉怎  | 安怎  | 俺怎  | 奥怎  | 案怎  | 吖怎  | 艾怎  | 昂怎  | 埃怎  | 暗怎  | 
azeng | 爱憎   | 啊曾  | 哎曾  | 阿曾  | 爱曾  | 按曾  | 唉曾  | 安曾  | 俺曾  | 奥曾  | 案曾  | 吖曾  | 艾曾  | 昂曾  | 埃曾  | 暗曾  | 
azha | 阿扎   | 安扎   | 啊炸  | 哎炸  | 阿炸  | 爱炸  | 按炸  | 唉炸  | 安炸  | 俺炸  | 奥炸  | 案炸  | 吖炸  | 艾炸  | 昂炸  | 埃炸  | 
azhai | 阿宅   | 安宅   | 矮寨   | 阿翟   | 啊宅  | 哎宅  | 阿宅  | 爱宅  | 按宅  | 唉宅  | 安宅  | 俺宅  | 奥宅  | 案宅  | 吖宅  | 艾宅  | 
azhan | 暗战   | 鏖战   | 爱占   | 傲战   | 爱站   | 阿展   | 奥展   | 啊站  | 哎站  | 阿站  | 爱站  | 按站  | 唉站  | 安站  | 俺站  | 奥站  | 
azhang | 按章   | 阿张   | 啊张  | 哎张  | 阿张  | 爱张  | 按张  | 唉张  | 安张  | 俺张  | 奥张  | 案张  | 吖张  | 艾张  | 昂张  | 埃张  | 
azhao | 按照   | 爱找   | 啊找   | 阿扎哦  | 安扎哦  | 啊找  | 哎找  | 阿找  | 爱找  | 按找  | 唉找  | 安找  | 俺找  | 奥找  | 案找  | 吖找  | 
azhe | 爱着   | 按着   | 挨着   | 碍着   | 阿哲   | 熬着   | 俺这   | 昂着   | 安哲   | 暗着   | 按这   | 啊这  | 哎这  | 阿这  | 爱这  | 按这  | 
azhei | 啊这   | 啊这  | 哎这  | 阿这  | 爱这  | 按这  | 唉这  | 安这  | 俺这  | 奥这  | 案这  | 吖这  | 艾这  | 昂这  | 埃这  | 暗这  | 
azhen | 安贞   | 安镇   | 阿珍   | 安枕   | 爱珍   | 阿真   | 阿贞   | 澳真   | 啊真  | 哎真  | 阿真  | 爱真  | 按真  | 唉真  | 安真  | 俺真  | 
azheng | 癌症   | 阿正   | 挨整   | 安正   | 啊正  | 哎正  | 阿正  | 爱正  | 按正  | 唉正  | 安正  | 俺正  | 奥正  | 案正  | 吖正  | 艾正  | 
azhi | 安置   | 爱之   | 熬制   | 暗指   | 暗之   | 爱知   | 安之   | 安智   | 安知   | 阿志   | 阿智   | 按质   | 案值   | 安质   | 按置   | 安芝   | 
azhong | 暗中   | 案中   | 爱中   | 癌肿   | 阿忠   | 爱众   | 安中   | 澳中   | 阿钟   | 啊中  | 哎中  | 阿中  | 爱中  | 按中  | 唉中  | 安中  | 
azhou | 澳洲   | 熬粥   | 安州   | 按周   | 阿周   | 暗咒   | 啊周  | 哎周  | 阿周  | 爱周  | 按周  | 唉周  | 安周  | 俺周  | 奥周  | 案周  | 
azhu | 按住   | 阿朱   | 案主   | 熬煮   | 安住   | 阿珠   | 阿猪   | 爱珠   | 爱主   | 暗柱   | 艾柱   | 爱猪   | 熬住   | 安珠   | 啊住  | 哎住  | 
azhua | 挨抓   | 按爪   | 暗爪   | 按住啊  | 阿朱啊  | 案主啊  | 熬煮啊  | 安住啊  | 阿珠啊  | 阿猪啊  | 爱珠啊  | 爱主啊  | 暗柱啊  | 艾柱啊  | 爱猪啊  | 熬住啊  | 
azhuai | 啊拽   | 按住哎  | 阿朱哎  | 案主哎  | 熬煮哎  | 安住哎  | 阿珠哎  | 阿猪哎  | 爱珠哎  | 爱主哎  | 暗柱哎  | 艾柱哎  | 爱猪哎  | 熬住哎  | 安珠哎  | 啊拽  | 
azhuan | 暗转   | 安装   | 按住按  | 阿朱按  | 案主按  | 熬煮按  | 安住按  | 阿珠按  | 阿猪按  | 爱珠按  | 爱主按  | 暗柱按  | 艾柱按  | 爱猪按  | 熬住按  | 安珠按  | 
azhuang | 安装   | 暗装   | 爱装   | 按装   | 安庄   | 阿庄   | 啊装   | 澳妆   | 按住昂  | 阿朱昂  | 案主昂  | 熬煮昂  | 安住昂  | 阿珠昂  | 阿猪昂  | 爱珠昂  | 
azhui | 啊追   | 啊追  | 哎追  | 阿追  | 爱追  | 按追  | 唉追  | 安追  | 俺追  | 奥追  | 案追  | 吖追  | 艾追  | 昂追  | 埃追  | 暗追  | 
azhun | 啊准   | 啊准  | 哎准  | 阿准  | 爱准  | 按准  | 唉准  | 安准  | 俺准  | 奥准  | 案准  | 吖准  | 艾准  | 昂准  | 埃准  | 暗准  | 
azhuo | 安卓   | 阿卓   | 案桌   | 按住哦  | 阿朱哦  | 案主哦  | 熬煮哦  | 安住哦  | 阿珠哦  | 阿猪哦  | 爱珠哦  | 爱主哦  | 暗柱哦  | 艾柱哦  | 爱猪哦  | 熬住哦  | 
azi | 案子   | 暗自   | 矮子   | 阿紫   | 艾滋   | 爱子   | 阿兹   | 奥兹   | 安子   | 袄子   | 暗紫   | 昂子   | 鞍子   | 安兹   | 阿梓   | 澳籽   | 
azong | 安总   | 艾总   | 爱总   | 敖总   | 案宗   | 啊总  | 哎总  | 阿总  | 爱总  | 按总  | 唉总  | 安总  | 俺总  | 奥总  | 案总  | 吖总  | 
azou | 挨揍   | 爱走   | 啊走   | 奥走   | 啊走  | 哎走  | 阿走  | 爱走  | 按走  | 唉走  | 安走  | 俺走  | 奥走  | 案走  | 吖走  | 艾走  | 
azu | 安祖   | 阿祖   | 按组   | 啊组  | 哎组  | 阿组  | 爱组  | 按组  | 唉组  | 安组  | 俺组  | 奥组  | 案组  | 吖组  | 艾组  | 昂组  | 
azuan | 阿祖安   | 安祖按  | 阿祖按  | 按组按  | 啊钻  | 哎钻  | 阿钻  | 爱钻  | 按钻  | 唉钻  | 安钻  | 俺钻  | 奥钻  | 案钻  | 吖钻  | 艾钻  | 
azui | 啊最   | 啊最  | 哎最  | 阿最  | 爱最  | 按最  | 唉最  | 安最  | 俺最  | 奥最  | 案最  | 吖最  | 艾最  | 昂最  | 埃最  | 暗最  | 
azun | 啊尊   | 啊尊  | 哎尊  | 阿尊  | 爱尊  | 按尊  | 唉尊  | 安尊  | 俺尊  | 奥尊  | 案尊  | 吖尊  | 艾尊  | 昂尊  | 埃尊  | 暗尊  | 
azuo | 爱做   | 安坐   | 鞍座   | 阿左   | 安祖哦  | 阿祖哦  | 按组哦  | 啊做  | 哎做  | 阿做  | 爱做  | 按做  | 唉做  | 安做  | 俺做  | 奥做  | 
aia | 爱啊   | 哎啊   | 哎啊  | 爱啊  | 唉啊  | 艾啊  | 埃啊  | 矮啊  | 挨啊  | 哀啊  | 癌啊  | 欸啊  | 嗳啊  | 碍啊  | 暧啊  | 蔼啊  | 
aiai | 爱爱   | 哎哎   | 唉唉   | 皑皑   | 艾艾   | 矮矮   | 哎哎  | 爱哎  | 唉哎  | 艾哎  | 埃哎  | 矮哎  | 挨哎  | 哀哎  | 癌哎  | 欸哎  | 
aian | 爱按   | 哎按  | 爱按  | 唉按  | 艾按  | 埃按  | 矮按  | 挨按  | 哀按  | 癌按  | 欸按  | 嗳按  | 碍按  | 暧按  | 蔼按  | 霭按  | 
aiang | 艾昂   | 哎昂  | 爱昂  | 唉昂  | 艾昂  | 埃昂  | 矮昂  | 挨昂  | 哀昂  | 癌昂  | 欸昂  | 嗳昂  | 碍昂  | 暧昂  | 蔼昂  | 霭昂  | 
aiao | 爱奥   | 爱啊哦  | 哎啊哦  | 哎奥  | 爱奥  | 唉奥  | 艾奥  | 埃奥  | 矮奥  | 挨奥  | 哀奥  | 癌奥  | 欸奥  | 嗳奥  | 碍奥  | 暧奥  | 
aiba | 爱吧   | 哎吧  | 爱吧  | 唉吧  | 艾吧  | 埃吧  | 矮吧  | 挨吧  | 哀吧  | 癌吧  | 欸吧  | 嗳吧  | 碍吧  | 暧吧  | 蔼吧  | 霭吧  | 
aibai | 爱白   | 哎白  | 爱白  | 唉白  | 艾白  | 埃白  | 矮白  | 挨白  | 哀白  | 癌白  | 欸白  | 嗳白  | 碍白  | 暧白  | 蔼白  | 霭白  | 
aiban | 爱版   | 哎版  | 爱版  | 唉版  | 艾版  | 埃版  | 矮版  | 挨版  | 哀版  | 癌版  | 欸版  | 嗳版  | 碍版  | 暧版  | 蔼版  | 霭版  | 
aibang | 爱帮   | 埃镑   | 爱邦   | 哎帮  | 爱帮  | 唉帮  | 艾帮  | 埃帮  | 矮帮  | 挨帮  | 哀帮  | 癌帮  | 欸帮  | 嗳帮  | 碍帮  | 暧帮  | 
aibao | 爱宝   | 艾宝   | 爱吧哦  | 哎包  | 爱包  | 唉包  | 艾包  | 埃包  | 矮包  | 挨包  | 哀包  | 癌包  | 欸包  | 嗳包  | 碍包  | 暧包  | 
aibei | 爱贝   | 哎被  | 爱被  | 唉被  | 艾被  | 埃被  | 矮被  | 挨被  | 哀被  | 癌被  | 欸被  | 嗳被  | 碍被  | 暧被  | 蔼被  | 霭被  | 
aiben | 埃本   | 艾本   | 哎本  | 爱本  | 唉本  | 艾本  | 埃本  | 矮本  | 挨本  | 哀本  | 癌本  | 欸本  | 嗳本  | 碍本  | 暧本  | 蔼本  | 
aibeng | 爱泵   | 哎泵  | 爱泵  | 唉泵  | 艾泵  | 埃泵  | 矮泵  | 挨泵  | 哀泵  | 癌泵  | 欸泵  | 嗳泵  | 碍泵  | 暧泵  | 蔼泵  | 霭泵  | 
aibi | 艾比   | 爱彼   | 哎比  | 爱比  | 唉比  | 艾比  | 埃比  | 矮比  | 挨比  | 哀比  | 癌比  | 欸比  | 嗳比  | 碍比  | 暧比  | 蔼比  | 
aibian | 癌变   | 挨边   | 艾比按  | 爱彼按  | 哎便  | 爱便  | 唉便  | 艾便  | 埃便  | 矮便  | 挨便  | 哀便  | 癌便  | 欸便  | 嗳便  | 碍便  | 
aibiang | 爱变更   | 癌变给  | 挨边给  | 艾比昂  | 爱彼昂  | 哎变更  | 爱变更  | 唉变更  | 艾变更  | 埃变更  | 矮变更  | 挨变更  | 哀变更  | 癌变更  | 欸变更  | 嗳变更  | 
aibiao | 爱表   | 艾比奥  | 爱彼奥  | 哎表  | 爱表  | 唉表  | 艾表  | 埃表  | 矮表  | 挨表  | 哀表  | 癌表  | 欸表  | 嗳表  | 碍表  | 暧表  | 
aibie | 爱别   | 艾比二  | 爱彼二  | 哎别  | 爱别  | 唉别  | 艾别  | 埃别  | 矮别  | 挨别  | 哀别  | 癌别  | 欸别  | 嗳别  | 碍别  | 暧别  | 
aibin | 艾彬   | 哎斌  | 爱斌  | 唉斌  | 艾斌  | 埃斌  | 矮斌  | 挨斌  | 哀斌  | 癌斌  | 欸斌  | 嗳斌  | 碍斌  | 暧斌  | 蔼斌  | 霭斌  | 
aibing | 爱兵   | 癌病   | 哎并  | 爱并  | 唉并  | 艾并  | 埃并  | 矮并  | 挨并  | 哀并  | 癌并  | 欸并  | 嗳并  | 碍并  | 暧并  | 蔼并  | 
aibo | 爱博   | 艾波   | 艾博   | 埃博   | 哎波  | 爱波  | 唉波  | 艾波  | 埃波  | 矮波  | 挨波  | 哀波  | 癌波  | 欸波  | 嗳波  | 碍波  | 
aibu | 爱不   | 爱步   | 哎不  | 爱不  | 唉不  | 艾不  | 埃不  | 矮不  | 挨不  | 哀不  | 癌不  | 欸不  | 嗳不  | 碍不  | 暧不  | 蔼不  | 
aica | 爱擦   | 哎擦  | 爱擦  | 唉擦  | 艾擦  | 埃擦  | 矮擦  | 挨擦  | 哀擦  | 癌擦  | 欸擦  | 嗳擦  | 碍擦  | 暧擦  | 蔼擦  | 霭擦  | 
aicai | 爱财   | 爱才   | 艾彩   | 哎才  | 爱才  | 唉才  | 艾才  | 埃才  | 矮才  | 挨才  | 哀才  | 癌才  | 欸才  | 嗳才  | 碍才  | 暧才  | 
aican | 爱惨   | 哎惨  | 爱惨  | 唉惨  | 艾惨  | 埃惨  | 矮惨  | 挨惨  | 哀惨  | 癌惨  | 欸惨  | 嗳惨  | 碍惨  | 暧惨  | 蔼惨  | 霭惨  | 
aicang | 爱藏   | 哎仓  | 爱仓  | 唉仓  | 艾仓  | 埃仓  | 矮仓  | 挨仓  | 哀仓  | 癌仓  | 欸仓  | 嗳仓  | 碍仓  | 暧仓  | 蔼仓  | 霭仓  | 
aicao | 艾草   | 哎操  | 爱操  | 唉操  | 艾操  | 埃操  | 矮操  | 挨操  | 哀操  | 癌操  | 欸操  | 嗳操  | 碍操  | 暧操  | 蔼操  | 霭操  | 
aice | 哀册   | 爱车   | 哎测  | 爱测  | 唉测  | 艾测  | 埃测  | 矮测  | 挨测  | 哀测  | 癌测  | 欸测  | 嗳测  | 碍测  | 暧测  | 蔼测  | 
aicei | 哀册i   | 哎测i  | 爱测i  | 唉测i  | 艾测i  | 埃测i  | 矮测i  | 挨测i  | 哀测i  | 癌测i  | 欸测i  | 嗳测i  | 碍测i  | 暧测i  | 蔼测i  | 霭测i  | 
aicen | 爱岑   | 哎岑  | 爱岑  | 唉岑  | 艾岑  | 埃岑  | 矮岑  | 挨岑  | 哀岑  | 癌岑  | 欸岑  | 嗳岑  | 碍岑  | 暧岑  | 蔼岑  | 霭岑  | 
aiceng | 爱曾   | 哎曾  | 爱曾  | 唉曾  | 艾曾  | 埃曾  | 矮曾  | 挨曾  | 哀曾  | 癌曾  | 欸曾  | 嗳曾  | 碍曾  | 暧曾  | 蔼曾  | 霭曾  | 
aicha | 爱茶   | 哎差  | 爱差  | 唉差  | 艾差  | 埃差  | 矮差  | 挨差  | 哀差  | 癌差  | 欸差  | 嗳差  | 碍差  | 暧差  | 蔼差  | 霭差  | 
aichai | 爱拆   | 哎拆  | 爱拆  | 唉拆  | 艾拆  | 埃拆  | 矮拆  | 挨拆  | 哀拆  | 癌拆  | 欸拆  | 嗳拆  | 碍拆  | 暧拆  | 蔼拆  | 霭拆  | 
aichan | 爱产   | 哎产  | 爱产  | 唉产  | 艾产  | 埃产  | 矮产  | 挨产  | 哀产  | 癌产  | 欸产  | 嗳产  | 碍产  | 暧产  | 蔼产  | 霭产  | 
aichang | 爱唱   | 艾畅   | 哎长  | 爱长  | 唉长  | 艾长  | 埃长  | 矮长  | 挨长  | 哀长  | 癌长  | 欸长  | 嗳长  | 碍长  | 暧长  | 蔼长  | 
aichao | 爱巢   | 挨吵   | 爱茶哦  | 哎超  | 爱超  | 唉超  | 艾超  | 埃超  | 矮超  | 挨超  | 哀超  | 癌超  | 欸超  | 嗳超  | 碍超  | 暧超  | 
aiche | 爱车   | 哎车  | 爱车  | 唉车  | 艾车  | 埃车  | 矮车  | 挨车  | 哀车  | 癌车  | 欸车  | 嗳车  | 碍车  | 暧车  | 蔼车  | 霭车  | 
aichen | 艾辰   | 哎陈  | 爱陈  | 唉陈  | 艾陈  | 埃陈  | 矮陈  | 挨陈  | 哀陈  | 癌陈  | 欸陈  | 嗳陈  | 碍陈  | 暧陈  | 蔼陈  | 霭陈  | 
aicheng | 爱称   | 爱城   | 哎成  | 爱成  | 唉成  | 艾成  | 埃成  | 矮成  | 挨成  | 哀成  | 癌成  | 欸成  | 嗳成  | 碍成  | 暧成  | 蔼成  | 
aichi | 爱吃   | 爱驰   | 哎吃  | 爱吃  | 唉吃  | 艾吃  | 埃吃  | 矮吃  | 挨吃  | 哀吃  | 癌吃  | 欸吃  | 嗳吃  | 碍吃  | 暧吃  | 蔼吃  | 
aichong | 爱宠   | 哎冲  | 爱冲  | 唉冲  | 艾冲  | 埃冲  | 矮冲  | 挨冲  | 哀冲  | 癌冲  | 欸冲  | 嗳冲  | 碍冲  | 暧冲  | 蔼冲  | 霭冲  | 
aichou | 哀愁   | 哎抽  | 爱抽  | 唉抽  | 艾抽  | 埃抽  | 矮抽  | 挨抽  | 哀抽  | 癌抽  | 欸抽  | 嗳抽  | 碍抽  | 暧抽  | 蔼抽  | 霭抽  | 
aichu | 爱出   | 哎出  | 爱出  | 唉出  | 艾出  | 埃出  | 矮出  | 挨出  | 哀出  | 癌出  | 欸出  | 嗳出  | 碍出  | 暧出  | 蔼出  | 霭出  | 
aichua | 爱出啊   | 爱出啊  | 哎欻  | 爱欻  | 唉欻  | 艾欻  | 埃欻  | 矮欻  | 挨欻  | 哀欻  | 癌欻  | 欸欻  | 嗳欻  | 碍欻  | 暧欻  | 蔼欻  | 
aichuai | 挨踹   | 爱出哎  | 哎踹  | 爱踹  | 唉踹  | 艾踹  | 埃踹  | 矮踹  | 挨踹  | 哀踹  | 癌踹  | 欸踹  | 嗳踹  | 碍踹  | 暧踹  | 蔼踹  | 
aichuan | 爱穿   | 爱出按  | 哎穿  | 爱穿  | 唉穿  | 艾穿  | 埃穿  | 矮穿  | 挨穿  | 哀穿  | 癌穿  | 欸穿  | 嗳穿  | 碍穿  | 暧穿  | 蔼穿  | 
aichuang | 爱创   | 爱出昂  | 哎床  | 爱床  | 唉床  | 艾床  | 埃床  | 矮床  | 挨床  | 哀床  | 癌床  | 欸床  | 嗳床  | 碍床  | 暧床  | 蔼床  | 
aichui | 爱吹   | 哎吹  | 爱吹  | 唉吹  | 艾吹  | 埃吹  | 矮吹  | 挨吹  | 哀吹  | 癌吹  | 欸吹  | 嗳吹  | 碍吹  | 暧吹  | 蔼吹  | 霭吹  | 
aichun | 爱春   | 哎春  | 爱春  | 唉春  | 艾春  | 埃春  | 矮春  | 挨春  | 哀春  | 癌春  | 欸春  | 嗳春  | 碍春  | 暧春  | 蔼春  | 霭春  | 
aichuo | 爱戳   | 爱出哦  | 哎戳  | 爱戳  | 唉戳  | 艾戳  | 埃戳  | 矮戳  | 挨戳  | 哀戳  | 癌戳  | 欸戳  | 嗳戳  | 碍戳  | 暧戳  | 蔼戳  | 
aici | 挨次   | 哀辞   | 哎此  | 爱此  | 唉此  | 艾此  | 埃此  | 矮此  | 挨此  | 哀此  | 癌此  | 欸此  | 嗳此  | 碍此  | 暧此  | 蔼此  | 
aicong | 爱从   | 哎从  | 爱从  | 唉从  | 艾从  | 埃从  | 矮从  | 挨从  | 哀从  | 癌从  | 欸从  | 嗳从  | 碍从  | 暧从  | 蔼从  | 霭从  | 
aicou | 爱凑   | 哎凑  | 爱凑  | 唉凑  | 艾凑  | 埃凑  | 矮凑  | 挨凑  | 哀凑  | 癌凑  | 欸凑  | 嗳凑  | 碍凑  | 暧凑  | 蔼凑  | 霭凑  | 
aicu | 爱粗   | 哎粗  | 爱粗  | 唉粗  | 艾粗  | 埃粗  | 矮粗  | 挨粗  | 哀粗  | 癌粗  | 欸粗  | 嗳粗  | 碍粗  | 暧粗  | 蔼粗  | 霭粗  | 
aicuan | 爱窜   | 哎窜  | 爱窜  | 唉窜  | 艾窜  | 埃窜  | 矮窜  | 挨窜  | 哀窜  | 癌窜  | 欸窜  | 嗳窜  | 碍窜  | 暧窜  | 蔼窜  | 霭窜  | 
aicui | 霭翠   | 哎崔  | 爱崔  | 唉崔  | 艾崔  | 埃崔  | 矮崔  | 挨崔  | 哀崔  | 癌崔  | 欸崔  | 嗳崔  | 碍崔  | 暧崔  | 蔼崔  | 霭崔  | 
aicun | 爱村   | 哎村  | 爱村  | 唉村  | 艾村  | 埃村  | 矮村  | 挨村  | 哀村  | 癌村  | 欸村  | 嗳村  | 碍村  | 暧村  | 蔼村  | 霭村  | 
aicuo | 爱错   | 哎错  | 爱错  | 唉错  | 艾错  | 埃错  | 矮错  | 挨错  | 哀错  | 癌错  | 欸错  | 嗳错  | 碍错  | 暧错  | 蔼错  | 霭错  | 
aida | 挨打   | 艾达   | 爱打   | 爱达   | 爱大   | 爱哒   | Aida   | 哎大  | 爱大  | 唉大  | 艾大  | 埃大  | 矮大  | 挨大  | 哀大  | 癌大  | 
aidai | 爱戴   | 哎带  | 爱带  | 唉带  | 艾带  | 埃带  | 矮带  | 挨带  | 哀带  | 癌带  | 欸带  | 嗳带  | 碍带  | 暧带  | 蔼带  | 霭带  | 
aidan | 艾丹   | Aidan   | 哎但  | 爱但  | 唉但  | 艾但  | 埃但  | 矮但  | 挨但  | 哀但  | 癌但  | 欸但  | 嗳但  | 碍但  | 暧但  | 蔼但  | 
aidang | 爱党   | 爱宕   | 埃当   | 哎当  | 爱当  | 唉当  | 艾当  | 埃当  | 矮当  | 挨当  | 哀当  | 癌当  | 欸当  | 嗳当  | 碍当  | 暧当  | 
aidao | 哀悼   | 爱到   | 挨到   | 挨刀   | 挨打哦  | 艾达哦  | 爱打哦  | 爱达哦  | 爱大哦  | 爱哒哦  | 哎到  | 爱到  | 唉到  | 艾到  | 埃到  | 矮到  | 
aide | 爱的   | 爱得   | 艾德   | 埃德   | 爱德   | 矮的   | 挨得   | aide   | 哎的  | 爱的  | 唉的  | 艾的  | 埃的  | 矮的  | 挨的  | 哀的  | 
aidei | 爱得   | 哎得  | 爱得  | 唉得  | 艾得  | 埃得  | 矮得  | 挨得  | 哀得  | 癌得  | 欸得  | 嗳得  | 碍得  | 暧得  | 蔼得  | 霭得  | 
aiden | 爱扽   | 哎扽  | 爱扽  | 唉扽  | 艾扽  | 埃扽  | 矮扽  | 挨扽  | 哀扽  | 癌扽  | 欸扽  | 嗳扽  | 碍扽  | 暧扽  | 蔼扽  | 霭扽  | 
aideng | 艾登   | 矮凳   | 哎等  | 爱等  | 唉等  | 艾等  | 埃等  | 矮等  | 挨等  | 哀等  | 癌等  | 欸等  | 嗳等  | 碍等  | 暧等  | 蔼等  | 
aidi | 艾迪   | 埃迪   | 爱迪   | 爱地   | 艾蒂   | 哎地  | 爱地  | 唉地  | 艾地  | 埃地  | 矮地  | 挨地  | 哀地  | 癌地  | 欸地  | 嗳地  | 
aidia | 艾迪啊   | 艾迪啊  | 埃迪啊  | 爱迪啊  | 爱地啊  | 艾蒂啊  | 哎嗲  | 爱嗲  | 唉嗲  | 艾嗲  | 埃嗲  | 矮嗲  | 挨嗲  | 哀嗲  | 癌嗲  | 欸嗲  | 
aidian | 矮点   | 爱点   | 艾蒂安   | 艾迪按  | 埃迪按  | 爱迪按  | 爱地按  | 艾蒂按  | 哎点  | 爱点  | 唉点  | 艾点  | 埃点  | 矮点  | 挨点  | 哀点  | 
aidiao | 挨叼   | 哀吊   | 艾迪奥  | 埃迪奥  | 爱迪奥  | 爱地奥  | 艾蒂奥  | 哎掉  | 爱掉  | 唉掉  | 艾掉  | 埃掉  | 矮掉  | 挨掉  | 哀掉  | 癌掉  | 
aidie | 哀帝俄   | 艾迪二  | 埃迪二  | 爱迪二  | 爱地二  | 艾蒂二  | 哎爹  | 爱爹  | 唉爹  | 艾爹  | 埃爹  | 矮爹  | 挨爹  | 哀爹  | 癌爹  | 欸爹  | 
aidin | 爱丁   | 哎顶  | 爱顶  | 唉顶  | 艾顶  | 埃顶  | 矮顶  | 挨顶  | 哀顶  | 癌顶  | 欸顶  | 嗳顶  | 碍顶  | 暧顶  | 蔼顶  | 霭顶  | 
aiding | 爱丁   | 哎顶  | 爱顶  | 唉顶  | 艾顶  | 埃顶  | 矮顶  | 挨顶  | 哀顶  | 癌顶  | 欸顶  | 嗳顶  | 碍顶  | 暧顶  | 蔼顶  | 霭顶  | 
aidiu | 爱丢   | 哎丢  | 爱丢  | 唉丢  | 艾丢  | 埃丢  | 矮丢  | 挨丢  | 哀丢  | 癌丢  | 欸丢  | 嗳丢  | 碍丢  | 暧丢  | 蔼丢  | 霭丢  | 
aidong | 挨冻   | 爱动   | 爱东   | 艾东   | 哎东  | 爱东  | 唉东  | 艾东  | 埃东  | 矮东  | 挨东  | 哀东  | 癌东  | 欸东  | 嗳东  | 碍东  | 
aidou | 爱豆   | 挨斗   | 哎都  | 爱都  | 唉都  | 艾都  | 埃都  | 矮都  | 挨都  | 哀都  | 癌都  | 欸都  | 嗳都  | 碍都  | 暧都  | 蔼都  | 
aidu | 爱读   | 爱都   | 哎都  | 爱都  | 唉都  | 艾都  | 埃都  | 矮都  | 挨都  | 哀都  | 癌都  | 欸都  | 嗳都  | 碍都  | 暧都  | 蔼都  | 
aiduan | 爱段   | 爱读按  | 爱都按  | 哎段  | 爱段  | 唉段  | 艾段  | 埃段  | 矮段  | 挨段  | 哀段  | 癌段  | 欸段  | 嗳段  | 碍段  | 暧段  | 
aidui | 爱对   | 挨怼   | 哎对   | 哎对  | 爱对  | 唉对  | 艾对  | 埃对  | 矮对  | 挨对  | 哀对  | 癌对  | 欸对  | 嗳对  | 碍对  | 暧对  | 
aidun | 挨顿   | 埃顿   | 哎吨  | 爱吨  | 唉吨  | 艾吨  | 埃吨  | 矮吨  | 挨吨  | 哀吨  | 癌吨  | 欸吨  | 嗳吨  | 碍吨  | 暧吨  | 蔼吨  | 
aiduo | 爱多   | 爱读哦  | 爱都哦  | 哎多  | 爱多  | 唉多  | 艾多  | 埃多  | 矮多  | 挨多  | 哀多  | 癌多  | 欸多  | 嗳多  | 碍多  | 暧多  | 
aie | 挨饿   | 哎二  | 爱二  | 唉二  | 艾二  | 埃二  | 矮二  | 挨二  | 哀二  | 癌二  | 欸二  | 嗳二  | 碍二  | 暧二  | 蔼二  | 霭二  | 
aiei | 爱欸   | 哎欸  | 爱欸  | 唉欸  | 艾欸  | 埃欸  | 矮欸  | 挨欸  | 哀欸  | 癌欸  | 欸欸  | 嗳欸  | 碍欸  | 暧欸  | 蔼欸  | 霭欸  | 
aien | 艾恩   | 爱恩   | 哎嗯  | 爱嗯  | 唉嗯  | 艾嗯  | 埃嗯  | 矮嗯  | 挨嗯  | 哀嗯  | 癌嗯  | 欸嗯  | 嗳嗯  | 碍嗯  | 暧嗯  | 蔼嗯  | 
aieng | 爱鞥   | 哎鞥  | 爱鞥  | 唉鞥  | 艾鞥  | 埃鞥  | 矮鞥  | 挨鞥  | 哀鞥  | 癌鞥  | 欸鞥  | 嗳鞥  | 碍鞥  | 暧鞥  | 蔼鞥  | 霭鞥  | 
aier | 埃尔   | 艾尔   | 爱尔   | 爱儿   | 哎二  | 爱二  | 唉二  | 艾二  | 埃二  | 矮二  | 挨二  | 哀二  | 癌二  | 欸二  | 嗳二  | 碍二  | 
aifa | 挨罚   | 爱发   | 爱法   | 哎发  | 爱发  | 唉发  | 艾发  | 埃发  | 矮发  | 挨发  | 哀发  | 癌发  | 欸发  | 嗳发  | 碍发  | 暧发  | 
aifan | 艾凡   | 哎饭  | 爱饭  | 唉饭  | 艾饭  | 埃饭  | 矮饭  | 挨饭  | 哀饭  | 癌饭  | 欸饭  | 嗳饭  | 碍饭  | 暧饭  | 蔼饭  | 霭饭  | 
aifang | 爱芳   | 艾方   | 哎放  | 爱放  | 唉放  | 艾放  | 埃放  | 矮放  | 挨放  | 哀放  | 癌放  | 欸放  | 嗳放  | 碍放  | 暧放  | 蔼放  | 
aifei | 爱妃   | 艾菲   | 爱飞   | 艾飞   | 哎非  | 爱非  | 唉非  | 艾非  | 埃非  | 矮非  | 挨非  | 哀非  | 癌非  | 欸非  | 嗳非  | 碍非  | 
aifen | 爱芬   | 哎分  | 爱分  | 唉分  | 艾分  | 埃分  | 矮分  | 挨分  | 哀分  | 癌分  | 欸分  | 嗳分  | 碍分  | 暧分  | 蔼分  | 霭分  | 
aifeng | 爱疯   | iPhone   | 哎风  | 爱风  | 唉风  | 艾风  | 埃风  | 矮风  | 挨风  | 哀风  | 癌风  | 欸风  | 嗳风  | 碍风  | 暧风  | 蔼风  | 
aifiao | 爱覅   | 哎覅  | 爱覅  | 唉覅  | 艾覅  | 埃覅  | 矮覅  | 挨覅  | 哀覅  | 癌覅  | 欸覅  | 嗳覅  | 碍覅  | 暧覅  | 蔼覅  | 霭覅  | 
aifo | 艾佛   | 哎佛  | 爱佛  | 唉佛  | 艾佛  | 埃佛  | 矮佛  | 挨佛  | 哀佛  | 癌佛  | 欸佛  | 嗳佛  | 碍佛  | 暧佛  | 蔼佛  | 霭佛  | 
aifou | 爱否   | 哎否  | 爱否  | 唉否  | 艾否  | 埃否  | 矮否  | 挨否  | 哀否  | 癌否  | 欸否  | 嗳否  | 碍否  | 暧否  | 蔼否  | 霭否  | 
aifu | 爱抚   | 艾弗   | 艾付   | 哎夫  | 爱夫  | 唉夫  | 艾夫  | 埃夫  | 矮夫  | 挨夫  | 哀夫  | 癌夫  | 欸夫  | 嗳夫  | 碍夫  | 暧夫  | 
aiga | 爱噶   | 哎噶  | 爱噶  | 唉噶  | 艾噶  | 埃噶  | 矮噶  | 挨噶  | 哀噶  | 癌噶  | 欸噶  | 嗳噶  | 碍噶  | 暧噶  | 蔼噶  | 霭噶  | 
aigai | 艾盖   | 哎该  | 爱该  | 唉该  | 艾该  | 埃该  | 矮该  | 挨该  | 哀该  | 癌该  | 欸该  | 嗳该  | 碍该  | 暧该  | 蔼该  | 霭该  | 
aigan | 爱干   | 哎干  | 爱干  | 唉干  | 艾干  | 埃干  | 矮干  | 挨干  | 哀干  | 癌干  | 欸干  | 嗳干  | 碍干  | 暧干  | 蔼干  | 霭干  | 
aigang | 爱岗   | 哎杠  | 爱杠  | 唉杠  | 艾杠  | 埃杠  | 矮杠  | 挨杠  | 哀杠  | 癌杠  | 欸杠  | 嗳杠  | 碍杠  | 暧杠  | 蔼杠  | 霭杠  | 
aigao | 爱搞   | 哀告   | 艾高   | 哎高  | 爱高  | 唉高  | 艾高  | 埃高  | 矮高  | 挨高  | 哀高  | 癌高  | 欸高  | 嗳高  | 碍高  | 暧高  | 
aige | 挨个   | 艾格   | 哀歌   | 矮个   | 爱格   | 爱歌   | 哎个  | 爱个  | 唉个  | 艾个  | 埃个  | 矮个  | 挨个  | 哀个  | 癌个  | 欸个  | 
aigei | 爱给   | 哎给  | 爱给  | 唉给  | 艾给  | 埃给  | 矮给  | 挨给  | 哀给  | 癌给  | 欸给  | 嗳给  | 碍给  | 暧给  | 蔼给  | 霭给  | 
aigen | 艾根   | 哎跟  | 爱跟  | 唉跟  | 艾跟  | 埃跟  | 矮跟  | 挨跟  | 哀跟  | 癌跟  | 欸跟  | 嗳跟  | 碍跟  | 暧跟  | 蔼跟  | 霭跟  | 
aigeng | 爱庚   | 哎更  | 爱更  | 唉更  | 艾更  | 埃更  | 矮更  | 挨更  | 哀更  | 癌更  | 欸更  | 嗳更  | 碍更  | 暧更  | 蔼更  | 霭更  | 
aigong | 艾工   | 哎共  | 爱共  | 唉共  | 艾共  | 埃共  | 矮共  | 挨共  | 哀共  | 癌共  | 欸共  | 嗳共  | 碍共  | 暧共  | 蔼共  | 霭共  | 
aigou | 爱狗   | 爱购   | 哎狗  | 爱狗  | 唉狗  | 艾狗  | 埃狗  | 矮狗  | 挨狗  | 哀狗  | 癌狗  | 欸狗  | 嗳狗  | 碍狗  | 暧狗  | 蔼狗  | 
aigu | 爱股   | 艾古   | 哎古  | 爱古  | 唉古  | 艾古  | 埃古  | 矮古  | 挨古  | 哀古  | 癌古  | 欸古  | 嗳古  | 碍古  | 暧古  | 蔼古  | 
aigua | 矮瓜   | 爱股啊  | 艾古啊  | 哎挂  | 爱挂  | 唉挂  | 艾挂  | 埃挂  | 矮挂  | 挨挂  | 哀挂  | 癌挂  | 欸挂  | 嗳挂  | 碍挂  | 暧挂  | 
aiguai | 爱怪   | 爱股哎  | 艾古哎  | 哎怪  | 爱怪  | 唉怪  | 艾怪  | 埃怪  | 矮怪  | 挨怪  | 哀怪  | 癌怪  | 欸怪  | 嗳怪  | 碍怪  | 暧怪  | 
aiguan | 爱管   | 爱股按  | 艾古按  | 哎管  | 爱管  | 唉管  | 艾管  | 埃管  | 矮管  | 挨管  | 哀管  | 癌管  | 欸管  | 嗳管  | 碍管  | 暧管  | 
aiguang | 爱逛   | 爱股昂  | 艾古昂  | 哎光  | 爱光  | 唉光  | 艾光  | 埃光  | 矮光  | 挨光  | 哀光  | 癌光  | 欸光  | 嗳光  | 碍光  | 暧光  | 
aigui | 矮柜   | 哎贵  | 爱贵  | 唉贵  | 艾贵  | 埃贵  | 矮贵  | 挨贵  | 哀贵  | 癌贵  | 欸贵  | 嗳贵  | 碍贵  | 暧贵  | 蔼贵  | 霭贵  | 
aigun | 爱滚   | 哎滚  | 爱滚  | 唉滚  | 艾滚  | 埃滚  | 矮滚  | 挨滚  | 哀滚  | 癌滚  | 欸滚  | 嗳滚  | 碍滚  | 暧滚  | 蔼滚  | 霭滚  | 
aiguo | 爱国   | 爱过   | 挨过   | 爱股哦  | 艾古哦  | 哎过  | 爱过  | 唉过  | 艾过  | 埃过  | 矮过  | 挨过  | 哀过  | 癌过  | 欸过  | 嗳过  | 
aiha | 艾哈   | 哎哈  | 爱哈  | 唉哈  | 艾哈  | 埃哈  | 矮哈  | 挨哈  | 哀哈  | 癌哈  | 欸哈  | 嗳哈  | 碍哈  | 暧哈  | 蔼哈  | 霭哈  | 
aihai | 爱海   | 哎嗨   | 哎还  | 爱还  | 唉还  | 艾还  | 埃还  | 矮还  | 挨还  | 哀还  | 癌还  | 欸还  | 嗳还  | 碍还  | 暧还  | 蔼还  | 
aihan | 爱涵   | 哎含  | 爱含  | 唉含  | 艾含  | 埃含  | 矮含  | 挨含  | 哀含  | 癌含  | 欸含  | 嗳含  | 碍含  | 暧含  | 蔼含  | 霭含  | 
aihang | 埃航   | 哎行  | 爱行  | 唉行  | 艾行  | 埃行  | 矮行  | 挨行  | 哀行  | 癌行  | 欸行  | 嗳行  | 碍行  | 暧行  | 蔼行  | 霭行  | 
aihao | 爱好   | 哀嚎   | 哀号   | 艾蒿   | 哎好   | 艾哈哦  | 哎好  | 爱好  | 唉好  | 艾好  | 埃好  | 矮好  | 挨好  | 哀好  | 癌好  | 欸好  | 
aihe | 爱和   | 爱河   | 爱喝   | 哎和  | 爱和  | 唉和  | 艾和  | 埃和  | 矮和  | 挨和  | 哀和  | 癌和  | 欸和  | 嗳和  | 碍和  | 暧和  | 
aihei | 矮黑   | 哎嘿   | 哎黑  | 爱黑  | 唉黑  | 艾黑  | 埃黑  | 矮黑  | 挨黑  | 哀黑  | 癌黑  | 欸黑  | 嗳黑  | 碍黑  | 暧黑  | 蔼黑  | 
aihen | 爱恨   | 哎很  | 爱很  | 唉很  | 艾很  | 埃很  | 矮很  | 挨很  | 哀很  | 癌很  | 欸很  | 嗳很  | 碍很  | 暧很  | 蔼很  | 霭很  | 
aiheng | 埃亨   | 爱恨   | 哎哼  | 爱哼  | 唉哼  | 艾哼  | 埃哼  | 矮哼  | 挨哼  | 哀哼  | 癌哼  | 欸哼  | 嗳哼  | 碍哼  | 暧哼  | 蔼哼  | 
aihm | 爱很美   | 爱好吗  | 爱护吗  | 爱和吗  | 爱河吗  | 爱恨吗  | 爱华吗  | 艾哈吗  | 爱喝吗  | 哀嚎吗  | 哀号吗  | 矮黑吗  | 艾蒿吗  | 爱火吗  | 爱红吗  | 爱花吗  | 
aihng | 埃航   | 爱好那个   | 爱护你给  | 爱好女给  | 爱好那个  | 爱护那个  | 爱和那个  | 爱河那个  | 爱恨那个  | 爱华那个  | 艾哈那个  | 爱喝那个  | 哀嚎那个  | 哀号那个  | 矮黑那个  | 艾蒿那个  | 
aihong | 爱红   | 哀鸿   | 艾红   | 哎红  | 爱红  | 唉红  | 艾红  | 埃红  | 矮红  | 挨红  | 哀红  | 癌红  | 欸红  | 嗳红  | 碍红  | 暧红  | 
aihou | 哀侯   | 哎后  | 爱后  | 唉后  | 艾后  | 埃后  | 矮后  | 挨后  | 哀后  | 癌后  | 欸后  | 嗳后  | 碍后  | 暧后  | 蔼后  | 霭后  | 
aihu | 爱护   | 艾虎   | 爱虎   | 挨户   | 哎胡  | 爱胡  | 唉胡  | 艾胡  | 埃胡  | 矮胡  | 挨胡  | 哀胡  | 癌胡  | 欸胡  | 嗳胡  | 碍胡  | 
aihua | 爱华   | 爱花   | 矮化   | 艾华   | 爱护啊  | 艾虎啊  | 爱虎啊  | 挨户啊  | 哎话  | 爱话  | 唉话  | 艾话  | 埃话  | 矮话  | 挨话  | 哀话  | 
aihuai | 爱坏   | 爱护哎  | 艾虎哎  | 爱虎哎  | 挨户哎  | 哎坏  | 爱坏  | 唉坏  | 艾坏  | 埃坏  | 矮坏  | 挨坏  | 哀坏  | 癌坏  | 欸坏  | 嗳坏  | 
aihuan | 爱换   | 爱护按  | 艾虎按  | 爱虎按  | 挨户按  | 哎换  | 爱换  | 唉换  | 艾换  | 埃换  | 矮换  | 挨换  | 哀换  | 癌换  | 欸换  | 嗳换  | 
aihuang | 爱黄   | 爱护昂  | 艾虎昂  | 爱虎昂  | 挨户昂  | 哎黄  | 爱黄  | 唉黄  | 艾黄  | 埃黄  | 矮黄  | 挨黄  | 哀黄  | 癌黄  | 欸黄  | 嗳黄  | 
aihui | 瑷珲   | 艾回   | 爱会   | 爱辉   | 哎会  | 爱会  | 唉会  | 艾会  | 埃会  | 矮会  | 挨会  | 哀会  | 癌会  | 欸会  | 嗳会  | 碍会  | 
aihun | 爱混   | 哎混  | 爱混  | 唉混  | 艾混  | 埃混  | 矮混  | 挨混  | 哀混  | 癌混  | 欸混  | 嗳混  | 碍混  | 暧混  | 蔼混  | 霭混  | 
aihuo | 爱火   | 爱护哦  | 艾虎哦  | 爱虎哦  | 挨户哦  | 哎或  | 爱或  | 唉或  | 艾或  | 埃或  | 矮或  | 挨或  | 哀或  | 癌或  | 欸或  | 嗳或  | 
aiji | 埃及   | 爱机   | 艾吉   | 挨挤   | 哎及  | 爱及  | 唉及  | 艾及  | 埃及  | 矮及  | 挨及  | 哀及  | 癌及  | 欸及  | 嗳及  | 碍及  | 
aijia | 哀家   | 爱家   | 爱佳   | 挨家   | 艾嘉   | 爱加   | 艾家   | 艾佳   | 艾加   | 埃加   | 埃及啊  | 爱机啊  | 艾吉啊  | 挨挤啊  | 哎加  | 爱加  | 
aijian | 挨肩   | 爱建   | 埃及按  | 爱机按  | 艾吉按  | 挨挤按  | 哎见  | 爱见  | 唉见  | 艾见  | 埃见  | 矮见  | 挨见  | 哀见  | 癌见  | 欸见  | 
aijiang | 爱将   | 爱讲   | 爱酱   | 哀酱   | 埃及昂  | 爱机昂  | 艾吉昂  | 挨挤昂  | 哎将  | 爱将  | 唉将  | 艾将  | 埃将  | 矮将  | 挨将  | 哀将  | 
aijiao | 矮脚   | 爱叫   | 艾吉奥   | 哀叫   | 挨浇   | 哀家哦  | 爱家哦  | 爱佳哦  | 挨家哦  | 艾嘉哦  | 爱加哦  | 艾家哦  | 艾佳哦  | 艾加哦  | 埃加哦  | 埃及奥  | 
aijie | 爱姐   | 艾姐   | 埃及二  | 爱机二  | 艾吉二  | 挨挤二  | 哎姐  | 爱姐  | 唉姐  | 艾姐  | 埃姐  | 矮姐  | 挨姐  | 哀姐  | 癌姐  | 欸姐  | 
aijin | 挨近   | 哀矜   | 哎金  | 爱金  | 唉金  | 艾金  | 埃金  | 矮金  | 挨金  | 哀金  | 癌金  | 欸金  | 嗳金  | 碍金  | 暧金  | 蔼金  | 
aijing | 艾敬   | 爱敬   | 爱静   | 爱经   | 哎经  | 爱经  | 唉经  | 艾经  | 埃经  | 矮经  | 挨经  | 哀经  | 癌经  | 欸经  | 嗳经  | 碍经  | 
aijiong | 爱囧   | 哎囧  | 爱囧  | 唉囧  | 艾囧  | 埃囧  | 矮囧  | 挨囧  | 哀囧  | 癌囧  | 欸囧  | 嗳囧  | 碍囧  | 暧囧  | 蔼囧  | 霭囧  | 
aijiu | 艾灸   | 爱就   | 爱酒   | 哎就  | 爱就  | 唉就  | 艾就  | 埃就  | 矮就  | 挨就  | 哀就  | 癌就  | 欸就  | 嗳就  | 碍就  | 暧就  | 
aiju | 爱菊   | 哎据  | 爱据  | 唉据  | 艾据  | 埃据  | 矮据  | 挨据  | 哀据  | 癌据  | 欸据  | 嗳据  | 碍据  | 暧据  | 蔼据  | 霭据  | 
aijuan | 爱娟   | 爱菊按  | 哎卷  | 爱卷  | 唉卷  | 艾卷  | 埃卷  | 矮卷  | 挨卷  | 哀卷  | 癌卷  | 欸卷  | 嗳卷  | 碍卷  | 暧卷  | 蔼卷  | 
aijue | 挨决   | 爱菊二  | 哎绝  | 爱绝  | 唉绝  | 艾绝  | 埃绝  | 矮绝  | 挨绝  | 哀绝  | 癌绝  | 欸绝  | 嗳绝  | 碍绝  | 暧绝  | 蔼绝  | 
aijun | 爱军   | 爱君   | 哎军  | 爱军  | 唉军  | 艾军  | 埃军  | 矮军  | 挨军  | 哀军  | 癌军  | 欸军  | 嗳军  | 碍军  | 暧军  | 蔼军  | 
aika | 爱卡   | 艾卡   | 哎卡  | 爱卡  | 唉卡  | 艾卡  | 埃卡  | 8   | 挨卡  | 哀卡  | 癌卡  | 欸卡  | 嗳卡  | 碍卡  | 暧卡  | 蔼卡  | 
aikai | 爱开   | 爱凯   | 哎开  | 爱开  | 唉开  | 艾开  | 埃开  | 矮开  | 挨开  | 哀开  | 癌开  | 欸开  | 嗳开  | 碍开  | 暧开  | 蔼开  | 
aikan | 爱看   | 哎看  | 爱看  | 唉看  | 艾看  | 埃看  | 矮看  | 挨看  | 哀看  | 癌看  | 欸看  | 嗳看  | 碍看  | 暧看  | 蔼看  | 霭看  | 
aikang | 爱康   | 艾康   | 哎康  | 爱康  | 唉康  | 艾康  | 埃康  | 矮康  | 挨康  | 哀康  | 癌康  | 欸康  | 嗳康  | 碍康  | 暧康  | 蔼康  | 
aikao | 挨靠   | 爱卡哦  | 艾卡哦  | 哎靠  | 爱靠  | 唉靠  | 艾靠  | 埃靠  | 矮靠  | 挨靠  | 哀靠  | 癌靠  | 欸靠  | 嗳靠  | 碍靠  | 暧靠  | 
aike | 艾克   | 埃克   | 爱克   | 艾柯   | 艾可   | 艾科   | 爱科   | 爱客   | 哎可  | 爱可  | 唉可  | 艾可  | 埃可  | 矮可  | 挨可  | 哀可  | 
aikei | 爱剋   | 哎剋  | 爱剋  | 唉剋  | 艾剋  | 埃剋  | 矮剋  | 挨剋  | 哀剋  | 癌剋  | 欸剋  | 嗳剋  | 碍剋  | 暧剋  | 蔼剋  | 霭剋  | 
aiken | 艾肯   | 哀恳   | 哎肯  | 爱肯  | 唉肯  | 艾肯  | 埃肯  | 矮肯  | 挨肯  | 哀肯  | 癌肯  | 欸肯  | 嗳肯  | 碍肯  | 暧肯  | 蔼肯  | 
aikeng | 哎坑   | 哎坑  | 爱坑  | 唉坑  | 艾坑  | 埃坑  | 矮坑  | 挨坑  | 哀坑  | 癌坑  | 欸坑  | 嗳坑  | 碍坑  | 暧坑  | 蔼坑  | 霭坑  | 
aikong | 爱空   | 哎空  | 爱空  | 唉空  | 艾空  | 埃空  | 矮空  | 挨空  | 哀空  | 癌空  | 欸空  | 嗳空  | 碍空  | 暧空  | 蔼空  | 霭空  | 
aikou | 隘口   | 碍口   | 哎口  | 爱口  | 唉口  | 艾口  | 埃口  | 矮口  | 挨口  | 哀口  | 癌口  | 欸口  | 嗳口  | 碍口  | 暧口  | 蔼口  | 
aiku | 爱哭   | 哀哭   | 爱酷   | 哎库  | 爱库  | 唉库  | 艾库  | 埃库  | 矮库  | 挨库  | 哀库  | 癌库  | 欸库  | 嗳库  | 碍库  | 暧库  | 
aikua | 爱哭啊   | 爱哭啊  | 哀哭啊  | 爱酷啊  | 哎跨  | 爱跨  | 唉跨  | 艾跨  | 埃跨  | 矮跨  | 挨跨  | 哀跨  | 癌跨  | 欸跨  | 嗳跨  | 碍跨  | 
aikuai | 爱快   | 爱哭哎  | 哀哭哎  | 爱酷哎  | 哎快  | 爱快  | 唉快  | 艾快  | 埃快  | 矮快  | 挨快  | 哀快  | 癌快  | 欸快  | 嗳快  | 碍快  | 
aikuan | 爱款   | 爱哭按  | 哀哭按  | 爱酷按  | 哎款  | 爱款  | 唉款  | 艾款  | 埃款  | 矮款  | 挨款  | 哀款  | 癌款  | 欸款  | 嗳款  | 碍款  | 
aikuang | 爱狂   | 爱哭昂  | 哀哭昂  | 爱酷昂  | 哎狂  | 爱狂  | 唉狂  | 艾狂  | 埃狂  | 矮狂  | 挨狂  | 哀狂  | 癌狂  | 欸狂  | 嗳狂  | 碍狂  | 
aikui | 艾奎   | 哎亏  | 爱亏  | 唉亏  | 艾亏  | 埃亏  | 矮亏  | 挨亏  | 哀亏  | 癌亏  | 欸亏  | 嗳亏  | 碍亏  | 暧亏  | 蔼亏  | 霭亏  | 
aikun | 爱困   | 哎困  | 爱困  | 唉困  | 艾困  | 埃困  | 矮困  | 挨困  | 哀困  | 癌困  | 欸困  | 嗳困  | 碍困  | 暧困  | 蔼困  | 霭困  | 
aikuo | 爱阔   | 爱哭哦  | 哀哭哦  | 爱酷哦  | 哎阔  | 爱阔  | 唉阔  | 艾阔  | 埃阔  | 矮阔  | 挨阔  | 哀阔  | 癌阔  | 欸阔  | 嗳阔  | 碍阔  | 
aila | 艾拉   | 爱拉   | 埃拉   | 哎啦  | 爱啦  | 唉啦  | 艾啦  | 埃啦  | 矮啦  | 挨啦  | 哀啦  | 癌啦  | 欸啦  | 嗳啦  | 碍啦  | 暧啦  | 
ailai | 爱来   | 艾莱   | 哎来  | 爱来  | 唉来  | 艾来  | 埃来  | 矮来  | 挨来  | 哀来  | 癌来  | 欸来  | 嗳来  | 碍来  | 暧来  | 蔼来  | 
ailan | 埃兰   | 爱兰   | 艾兰   | 哎蓝  | 爱蓝  | 唉蓝  | 艾蓝  | 埃蓝  | 矮蓝  | 挨蓝  | 哀蓝  | 癌蓝  | 欸蓝  | 嗳蓝  | 碍蓝  | 暧蓝  | 
ailang | 爱郎   | 爱浪   | 艾朗   | 哎狼  | 爱狼  | 唉狼  | 艾狼  | 埃狼  | 矮狼  | 挨狼  | 哀狼  | 癌狼  | 欸狼  | 嗳狼  | 碍狼  | 暧狼  | 
ailao | 爱老   | 艾拉哦  | 爱拉哦  | 埃拉哦  | 哎老  | 爱老  | 唉老  | 艾老  | 埃老  | 矮老  | 挨老  | 哀老  | 癌老  | 欸老  | 嗳老  | 碍老  | 
aile | 爱了   | 挨了   | 矮了   | 艾乐   | 爱乐   | Aileen   | 哎了  | 爱了  | 唉了  | 艾了  | 埃了  | 矮了  | 挨了  | 哀了  | 癌了  | 欸了  | 
ailei | 埃雷   | 艾蕾   | 哎类  | 爱类  | 唉类  | 艾类  | 埃类  | 矮类  | 挨类  | 哀类  | 癌类  | 欸类  | 嗳类  | 碍类  | 暧类  | 蔼类  | 
ailen | 爱冷   | 爱人   | 哎冷  | 爱冷  | 唉冷  | 艾冷  | 埃冷  | 矮冷  | 挨冷  | 哀冷  | 癌冷  | 欸冷  | 嗳冷  | 碍冷  | 暧冷  | 蔼冷  | 
aileng | 爱冷   | 哎冷  | 爱冷  | 唉冷  | 艾冷  | 埃冷  | 矮冷  | 挨冷  | 哀冷  | 癌冷  | 欸冷  | 嗳冷  | 碍冷  | 暧冷  | 蔼冷  | 霭冷  | 
aili | 艾莉   | 爱丽   | 艾利   | 艾力   | 艾丽   | 艾里   | 爱里   | 爱莉   | 爱理   | 艾黎   | 埃莉   | ailing   | 哎里  | 爱里  | 唉里  | 艾里  | 
ailia | 埃利阿   | 艾莉啊  | 爱丽啊  | 艾利啊  | 艾力啊  | 艾丽啊  | 艾里啊  | 爱里啊  | 爱莉啊  | 爱理啊  | 艾黎啊  | 埃莉啊  | 哎俩  | 爱俩  | 唉俩  | 艾俩  | 
ailian | 爱恋   | 爱怜   | 爱莲   | 哀怜   | 爱联   | 艾莉按  | 爱丽按  | 艾利按  | 艾力按  | 艾丽按  | 艾里按  | 爱里按  | 爱莉按  | 爱理按  | 艾黎按  | 埃莉按  | 
ailiang | 爱靓   | 爱恋   | 艾莉昂  | 爱丽昂  | 艾利昂  | 艾力昂  | 艾丽昂  | 艾里昂  | 爱里昂  | 爱莉昂  | 爱理昂  | 艾黎昂  | 埃莉昂  | 哎两  | 爱两  | 唉两  | 
ailiao | 爱聊   | 艾莉奥  | 爱丽奥  | 艾利奥  | 艾力奥  | 艾丽奥  | 艾里奥  | 爱里奥  | 爱莉奥  | 爱理奥  | 艾黎奥  | 埃莉奥  | 哎了  | 爱了  | 唉了  | 艾了  | 
ailie | 埃列   | 艾莉二  | 爱丽二  | 艾利二  | 艾力二  | 艾丽二  | 艾里二  | 爱里二  | 爱莉二  | 爱理二  | 艾黎二  | 埃莉二  | 哎列  | 爱列  | 唉列  | 艾列  | 
ailin | 艾琳   | 爱琳   | 爱林   | 艾林   | 挨淋   | ailing   | 哎林  | 爱林  | 唉林  | 艾林  | 埃林  | 矮林  | 挨林  | 哀林  | 癌林  | 欸林  | 
ailing | 爱玲   | 艾玲   | ailing   | 哎零  | 爱零  | 唉零  | 艾零  | 埃零  | 矮零  | 挨零  | 哀零  | 癌零  | 欸零  | 嗳零  | 碍零  | 暧零  | 
ailiu | 癌瘤   | 哎六  | 爱六  | 唉六  | 艾六  | 埃六  | 矮六  | 挨六  | 哀六  | 癌六  | 欸六  | 嗳六  | 碍六  | 暧六  | 蔼六  | 霭六  | 
ailo | 爱咯   | 哎咯  | 爱咯  | 唉咯  | 艾咯  | 埃咯  | 矮咯  | 挨咯  | 哀咯  | 癌咯  | 欸咯  | 嗳咯  | 碍咯  | 暧咯  | 蔼咯  | 霭咯  | 
ailong | 埃隆   | 爱龙   | 艾龙   | 哎龙  | 爱龙  | 唉龙  | 艾龙  | 埃龙  | 矮龙  | 挨龙  | 哀龙  | 癌龙  | 欸龙  | 嗳龙  | 碍龙  | 暧龙  | 
ailou | 艾露   | 哎楼  | 爱楼  | 唉楼  | 艾楼  | 埃楼  | 矮楼  | 挨楼  | 哀楼  | 癌楼  | 欸楼  | 嗳楼  | 碍楼  | 暧楼  | 蔼楼  | 霭楼  | 
ailu | 艾鲁   | 艾路   | 艾露   | 隘路   | 爱炉   | 哎路  | 爱路  | 唉路  | 艾路  | 埃路  | 矮路  | 挨路  | 哀路  | 癌路  | 欸路  | 嗳路  | 
ailuan | 爱乱   | 艾鲁按  | 艾路按  | 艾露按  | 隘路按  | 爱炉按  | 哎乱  | 爱乱  | 唉乱  | 艾乱  | 埃乱  | 矮乱  | 挨乱  | 哀乱  | 癌乱  | 欸乱  | 
ailun | 艾伦   | 爱伦   | 哎论  | 爱论  | 唉论  | 艾论  | 埃论  | 矮论  | 挨论  | 哀论  | 癌论  | 欸论  | 嗳论  | 碍论  | 暧论  | 蔼论  | 
ailuo | 埃罗   | 爱罗   | 爱洛   | 爱络   | 埃洛   | 艾鲁哦  | 艾路哦  | 艾露哦  | 隘路哦  | 爱炉哦  | 哎罗  | 爱罗  | 唉罗  | 艾罗  | 埃罗  | 矮罗  | 
ailv | 爱侣   | 哀绿   | 哎率  | 爱率  | 唉率  | 艾率  | 埃率  | 矮率  | 挨率  | 哀率  | 癌率  | 欸率  | 嗳率  | 碍率  | 暧率  | 蔼率  | 
ailve | 艾略   | 爱侣二  | 哀绿二  | 哎略  | 爱略  | 唉略  | 艾略  | 埃略  | 矮略  | 挨略  | 哀略  | 癌略  | 欸略  | 嗳略  | 碍略  | 暧略  | 
aim | 暧昧   | 艾玛   | 挨骂   | 爱慕   | 爱美   | 艾米   | 爱民   | 艾美   | 爱吗   | 爱玛   | 埃蒙   | 埃米   | 爱猫   | 哀鸣   | 爱买   | 爱梅   | 
aima | 艾玛   | 挨骂   | 爱吗   | 爱玛   | 😆   | 矮马   | 爱马   | 哎妈   | 哎嘛   | 哎吗  | 爱吗  | 唉吗  | 艾吗  | 埃吗  | 矮吗  | 挨吗  | 
aimai | 爱买   | 爱卖   | 哎买  | 爱买  | 唉买  | 艾买  | 埃买  | 矮买  | 挨买  | 哀买  | 癌买  | 欸买  | 嗳买  | 碍买  | 暧买  | 蔼买  | 
aiman | 艾曼   | 哎满  | 爱满  | 唉满  | 艾满  | 埃满  | 矮满  | 挨满  | 哀满  | 癌满  | 欸满  | 嗳满  | 碍满  | 暧满  | 蔼满  | 霭满  | 
aimang | 埃芒   | 哎忙  | 爱忙  | 唉忙  | 艾忙  | 埃忙  | 矮忙  | 挨忙  | 哀忙  | 癌忙  | 欸忙  | 嗳忙  | 碍忙  | 暧忙  | 蔼忙  | 霭忙  | 
aimao | 爱猫   | 艾玛哦  | 挨骂哦  | 爱吗哦  | 爱玛哦  | 矮马哦  | 爱马哦  | 哎妈哦  | 哎嘛哦  | 哎毛  | 爱毛  | 唉毛  | 艾毛  | 埃毛  | 矮毛  | 挨毛  | 
aime | 爱么   | aimed   | 哎么  | 爱么  | 唉么  | 艾么  | 埃么  | 矮么  | 挨么  | 哀么  | 癌么  | 欸么  | 嗳么  | 碍么  | 暧么  | 蔼么  | 
aimei | 暧昧   | 爱美   | 艾美   | 爱梅   | 艾梅   | 埃美   | 哎没  | 爱没  | 唉没  | 艾没  | 埃没  | 矮没  | 挨没  | 哀没  | 癌没  | 欸没  | 
aimen | 挨门   | 哎们  | 爱们  | 唉们  | 艾们  | 埃们  | 矮们  | 挨们  | 哀们  | 癌们  | 欸们  | 嗳们  | 碍们  | 暧们  | 蔼们  | 霭们  | 
aimeng | 埃蒙   | 爱梦   | 艾萌   | 哎梦  | 爱梦  | 唉梦  | 艾梦  | 埃梦  | 矮梦  | 挨梦  | 哀梦  | 癌梦  | 欸梦  | 嗳梦  | 碍梦  | 暧梦  | 
aimi | 艾米   | 埃米   | 爱米   | 艾咪   | 哎米  | 爱米  | 唉米  | 艾米  | 埃米  | 矮米  | 挨米  | 哀米  | 癌米  | 欸米  | 嗳米  | 碍米  | 
aimian | 爱面   | 艾米按  | 埃米按  | 爱米按  | 艾咪按  | 哎面  | 爱面  | 唉面  | 艾面  | 埃面  | 矮面  | 挨面  | 哀面  | 癌面  | 欸面  | 嗳面  | 
aimiao | 爱喵   | 艾米奥  | 埃米奥  | 爱米奥  | 艾咪奥  | 哎秒  | 爱秒  | 唉秒  | 艾秒  | 埃秒  | 矮秒  | 挨秒  | 哀秒  | 癌秒  | 欸秒  | 嗳秒  | 
aimie | 爱灭   | 艾米二  | 埃米二  | 爱米二  | 艾咪二  | 哎灭  | 爱灭  | 唉灭  | 艾灭  | 埃灭  | 矮灭  | 挨灭  | 哀灭  | 癌灭  | 欸灭  | 嗳灭  | 
aimin | 爱民   | 艾敏   | 哎民  | 爱民  | 唉民  | 艾民  | 埃民  | 矮民  | 挨民  | 哀民  | 癌民  | 欸民  | 嗳民  | 碍民  | 暧民  | 蔼民  | 
aiming | 哀鸣   | 爱明   | 爱名   | 哎名  | 爱名  | 唉名  | 艾名  | 埃名  | 矮名  | 挨名  | 哀名  | 癌名  | 欸名  | 嗳名  | 碍名  | 暧名  | 
aimiu | 爱谬   | 哎缪  | 爱缪  | 唉缪  | 艾缪  | 埃缪  | 矮缪  | 挨缪  | 哀缪  | 癌缪  | 欸缪  | 嗳缪  | 碍缪  | 暧缪  | 蔼缪  | 霭缪  | 
aimo | 癌魔   | 埃莫   | 哎莫  | 爱莫  | 唉莫  | 艾莫  | 埃莫  | 矮莫  | 挨莫  | 哀莫  | 癌莫  | 欸莫  | 嗳莫  | 碍莫  | 暧莫  | 蔼莫  | 
aimou | 爱某   | 哎某  | 爱某  | 唉某  | 艾某  | 埃某  | 矮某  | 挨某  | 哀某  | 癌某  | 欸某  | 嗳某  | 碍某  | 暧某  | 蔼某  | 霭某  | 
aimu | 爱慕   | 哎木  | 爱木  | 唉木  | 艾木  | 埃木  | 矮木  | 挨木  | 哀木  | 癌木  | 欸木  | 嗳木  | 碍木  | 暧木  | 蔼木  | 霭木  | 
ain | 爱你   | 爱女   | 爱您   | 爱呢   | 艾诺   | 碍难   | 艾尼   | 爱能   | 埃尼   | 爱闹   | 爱娜   | 爱鸟   | 艾妮   | 爱奴   | 爱农   | 爱念   | 
aina | 爱娜   | 艾娜   | 爱纳   | 哎那  | 爱那  | 唉那  | 艾那  | 埃那  | 矮那  | 挨那  | 哀那  | 癌那  | 欸那  | 嗳那  | 碍那  | 暧那  | 
ainai | 爱乃   | 欸乃   | 哎奶  | 爱奶  | 唉奶  | 艾奶  | 埃奶  | 矮奶  | 挨奶  | 哀奶  | 癌奶  | 欸奶  | 嗳奶  | 碍奶  | 暧奶  | 蔼奶  | 
ainan | 碍难   | 哎男  | 爱男  | 唉男  | 艾男  | 埃男  | 矮男  | 挨男  | 哀男  | 癌男  | 欸男  | 嗳男  | 碍男  | 暧男  | 蔼男  | 霭男  | 
ainang | 爱囊   | 哎囊  | 爱囊  | 唉囊  | 艾囊  | 埃囊  | 矮囊  | 挨囊  | 哀囊  | 癌囊  | 欸囊  | 嗳囊  | 碍囊  | 暧囊  | 蔼囊  | 霭囊  | 
ainao | 爱闹   | 爱娜哦  | 艾娜哦  | 爱纳哦  | 哎闹  | 爱闹  | 唉闹  | 艾闹  | 埃闹  | 矮闹  | 挨闹  | 哀闹  | 癌闹  | 欸闹  | 嗳闹  | 碍闹  | 
aine | 爱呢   | 哎呢  | 爱呢  | 唉呢  | 艾呢  | 埃呢  | 矮呢  | 挨呢  | 哀呢  | 癌呢  | 欸呢  | 嗳呢  | 碍呢  | 暧呢  | 蔼呢  | 霭呢  | 
ainei | 埃内   | 哎内  | 爱内  | 唉内  | 艾内  | 埃内  | 矮内  | 挨内  | 哀内  | 癌内  | 欸内  | 嗳内  | 碍内  | 暧内  | 蔼内  | 霭内  | 
ainen | 爱嫩   | 哎嫩  | 爱嫩  | 唉嫩  | 艾嫩  | 埃嫩  | 矮嫩  | 挨嫩  | 哀嫩  | 癌嫩  | 欸嫩  | 嗳嫩  | 碍嫩  | 暧嫩  | 蔼嫩  | 霭嫩  | 
aineng | 爱能   | 哎能  | 爱能  | 唉能  | 艾能  | 埃能  | 矮能  | 挨能  | 哀能  | 癌能  | 欸能  | 嗳能  | 碍能  | 暧能  | 蔼能  | 霭能  | 
aing | 啊ing   | 爱你给  | 爱女给  | 爱您给  | 爱呢给  | 艾诺给  | 碍难给  | 艾尼给  | 爱能给  | 埃尼给  | 爱闹给  | 爱娜给  | 爱鸟给  | 艾妮给  | 爱奴给  | 爱农给  | 
aini | 爱你   | 艾尼   | 埃尼   | 艾妮   | 😘   | 挨你   | 哎你   | 哎你  | 爱你  | 唉你  | 艾你  | 埃你  | 矮你  | 挨你  | 哀你  | 癌你  | 
ainia | 爱鸟   | 爱你啊   | 爱念   | 爱你啊  | 艾尼啊  | 埃尼啊  | 艾妮啊  | 挨你啊  | 哎你啊  | 哎年  | 爱年  | 唉年  | 艾年  | 埃年  | 矮年  | 挨年  | 
ainian | 爱念   | 爱你按  | 艾尼按  | 埃尼按  | 艾妮按  | 挨你按  | 哎你按  | 哎年  | 爱年  | 唉年  | 艾年  | 埃年  | 矮年  | 挨年  | 哀年  | 癌年  | 
ainiang | 艾尼昂   | 爱你昂  | 艾尼昂  | 埃尼昂  | 艾妮昂  | 挨你昂  | 哎你昂  | 哎娘  | 爱娘  | 唉娘  | 艾娘  | 埃娘  | 矮娘  | 挨娘  | 哀娘  | 癌娘  | 
ainiao | 爱鸟   | 爱你啊哦  | 爱你奥  | 艾尼奥  | 埃尼奥  | 艾妮奥  | 挨你奥  | 哎你奥  | 哎鸟  | 爱鸟  | 唉鸟  | 艾鸟  | 埃鸟  | 矮鸟  | 挨鸟  | 哀鸟  | 
ainie | 埃涅   | 爱你二  | 艾尼二  | 埃尼二  | 艾妮二  | 挨你二  | 哎你二  | 哎捏  | 爱捏  | 唉捏  | 艾捏  | 埃捏  | 矮捏  | 挨捏  | 哀捏  | 癌捏  | 
ainin | 爱您   | 哎您  | 爱您  | 唉您  | 艾您  | 埃您  | 矮您  | 挨您  | 哀您  | 癌您  | 欸您  | 嗳您  | 碍您  | 暧您  | 蔼您  | 霭您  | 
aining | 艾宁   | 哎宁  | 爱宁  | 唉宁  | 艾宁  | 埃宁  | 矮宁  | 挨宁  | 哀宁  | 癌宁  | 欸宁  | 嗳宁  | 碍宁  | 暧宁  | 蔼宁  | 霭宁  | 
ainiu | 艾纽   | 哎牛  | 爱牛  | 唉牛  | 艾牛  | 埃牛  | 矮牛  | 挨牛  | 哀牛  | 癌牛  | 欸牛  | 嗳牛  | 碍牛  | 暧牛  | 蔼牛  | 霭牛  | 
ainong | 爱农   | 艾农   | 哎弄  | 爱弄  | 唉弄  | 艾弄  | 埃弄  | 矮弄  | 挨弄  | 哀弄  | 癌弄  | 欸弄  | 嗳弄  | 碍弄  | 暧弄  | 蔼弄  | 
ainou | 爱耨   | 艾露   | 哎耨  | 爱耨  | 唉耨  | 艾耨  | 埃耨  | 矮耨  | 挨耨  | 哀耨  | 癌耨  | 欸耨  | 嗳耨  | 碍耨  | 暧耨  | 蔼耨  | 
ainu | 爱奴   | 哎怒  | 爱怒  | 唉怒  | 艾怒  | 埃怒  | 矮怒  | 挨怒  | 哀怒  | 癌怒  | 欸怒  | 嗳怒  | 碍怒  | 暧怒  | 蔼怒  | 霭怒  | 
ainuan | 爱暖   | 爱奴按  | 哎暖  | 爱暖  | 唉暖  | 艾暖  | 埃暖  | 矮暖  | 挨暖  | 哀暖  | 癌暖  | 欸暖  | 嗳暖  | 碍暖  | 暧暖  | 蔼暖  | 
ainun | 艾伦   | 哎黁  | 爱黁  | 唉黁  | 艾黁  | 埃黁  | 矮黁  | 挨黁  | 哀黁  | 癌黁  | 欸黁  | 嗳黁  | 碍黁  | 暧黁  | 蔼黁  | 霭黁  | 
ainuo | 艾诺   | 爱诺   | 爱奴哦  | 哎诺  | 爱诺  | 唉诺  | 艾诺  | 埃诺  | 矮诺  | 挨诺  | 哀诺  | 癌诺  | 欸诺  | 嗳诺  | 碍诺  | 暧诺  | 
ainv | 爱女   | 哎女  | 爱女  | 唉女  | 艾女  | 埃女  | 矮女  | 挨女  | 哀女  | 癌女  | 欸女  | 嗳女  | 碍女  | 暧女  | 蔼女  | 霭女  | 
ainve | 挨虐   | 爱女二  | 哎虐  | 爱虐  | 唉虐  | 艾虐  | 埃虐  | 矮虐  | 挨虐  | 哀虐  | 癌虐  | 欸虐  | 嗳虐  | 碍虐  | 暧虐  | 蔼虐  | 
aio | 爱哦   | 哎哦   | 哎哦  | 爱哦  | 唉哦  | 艾哦  | 埃哦  | 矮哦  | 挨哦  | 哀哦  | 癌哦  | 欸哦  | 嗳哦  | 碍哦  | 暧哦  | 蔼哦  | 
aiou | 艾欧   | 哎偶  | 爱偶  | 唉偶  | 艾偶  | 埃偶  | 矮偶  | 挨偶  | 哀偶  | 癌偶  | 欸偶  | 嗳偶  | 碍偶  | 暧偶  | 蔼偶  | 霭偶  | 
aipa | 埃帕   | 哎怕  | 爱怕  | 唉怕  | 艾怕  | 埃怕  | 矮怕  | 挨怕  | 哀怕  | 癌怕  | 欸怕  | 嗳怕  | 碍怕  | 暧怕  | 蔼怕  | 霭怕  | 
aipai | 爱拍   | 爱派   | 哎拍  | 爱拍  | 唉拍  | 艾拍  | 埃拍  | 矮拍  | 挨拍  | 哀拍  | 癌拍  | 欸拍  | 嗳拍  | 碍拍  | 暧拍  | 蔼拍  | 
aipan | 爱盘   | 哎盘  | 爱盘  | 唉盘  | 艾盘  | 埃盘  | 矮盘  | 挨盘  | 哀盘  | 癌盘  | 欸盘  | 嗳盘  | 碍盘  | 暧盘  | 蔼盘  | 霭盘  | 
aipang | 矮胖   | 癌旁   | 哎胖  | 爱胖  | 唉胖  | 艾胖  | 埃胖  | 矮胖  | 挨胖  | 哀胖  | 癌胖  | 欸胖  | 嗳胖  | 碍胖  | 暧胖  | 蔼胖  | 
aipao | 爱跑   | 挨炮   | 哎跑  | 爱跑  | 唉跑  | 艾跑  | 埃跑  | 矮跑  | 挨跑  | 哀跑  | 癌跑  | 欸跑  | 嗳跑  | 碍跑  | 暧跑  | 蔼跑  | 
aipei | 癌胚   | 哎配  | 爱配  | 唉配  | 艾配  | 埃配  | 矮配  | 挨配  | 哀配  | 癌配  | 欸配  | 嗳配  | 碍配  | 暧配  | 蔼配  | 霭配  | 
aipen | 挨喷   | 哎喷  | 爱喷  | 唉喷  | 艾喷  | 埃喷  | 矮喷  | 挨喷  | 哀喷  | 癌喷  | 欸喷  | 嗳喷  | 碍喷  | 暧喷  | 蔼喷  | 霭喷  | 
aipeng | 艾蓬   | 艾鹏   | 哎彭  | 爱彭  | 唉彭  | 艾彭  | 埃彭  | 矮彭  | 挨彭  | 哀彭  | 癌彭  | 欸彭  | 嗳彭  | 碍彭  | 暧彭  | 蔼彭  | 
aipi | 挨批   | 哎皮  | 爱皮  | 唉皮  | 艾皮  | 埃皮  | 矮皮  | 挨皮  | 哀皮  | 癌皮  | 欸皮  | 嗳皮  | 碍皮  | 暧皮  | 蔼皮  | 霭皮  | 
aipian | 挨骗   | 挨批按  | 哎篇  | 爱篇  | 唉篇  | 艾篇  | 埃篇  | 矮篇  | 挨篇  | 哀篇  | 癌篇  | 欸篇  | 嗳篇  | 碍篇  | 暧篇  | 蔼篇  | 
aipiao | 爱票   | 挨批奥  | 哎票  | 爱票  | 唉票  | 艾票  | 埃票  | 矮票  | 挨票  | 哀票  | 癌票  | 欸票  | 嗳票  | 碍票  | 暧票  | 蔼票  | 
aipie | 埃匹厄   | 挨批二  | 哎撇  | 爱撇  | 唉撇  | 艾撇  | 埃撇  | 矮撇  | 挨撇  | 哀撇  | 癌撇  | 欸撇  | 嗳撇  | 碍撇  | 暧撇  | 蔼撇  | 
aipin | 爱拼   | 哎品  | 爱品  | 唉品  | 艾品  | 埃品  | 矮品  | 挨品  | 哀品  | 癌品  | 欸品  | 嗳品  | 碍品  | 暧品  | 蔼品  | 霭品  | 
aiping | 爱平   | 爱萍   | 哎平  | 爱平  | 唉平  | 艾平  | 埃平  | 矮平  | 挨平  | 哀平  | 癌平  | 欸平  | 嗳平  | 碍平  | 暧平  | 蔼平  | 
aipo | 爱泼   | 哎破  | 爱破  | 唉破  | 艾破  | 埃破  | 矮破  | 挨破  | 哀破  | 癌破  | 欸破  | 嗳破  | 碍破  | 暧破  | 蔼破  | 霭破  | 
aipou | 爱剖   | 哎剖  | 爱剖  | 唉剖  | 艾剖  | 埃剖  | 矮剖  | 挨剖  | 哀剖  | 癌剖  | 欸剖  | 嗳剖  | 碍剖  | 暧剖  | 蔼剖  | 霭剖  | 
aipu | 爱普   | 艾普   | 哎普  | 爱普  | 唉普  | 艾普  | 埃普  | 矮普  | 挨普  | 哀普  | 癌普  | 欸普  | 嗳普  | 碍普  | 暧普  | 蔼普  | 
aiqi | 爱妻   | 艾奇   | 艾琪   | 嗳气   | 爱奇   | 哀戚   | 哀泣   | 哎其  | 爱其  | 唉其  | 艾其  | 埃其  | 矮其  | 挨其  | 哀其  | 癌其  | 
aiqia | 爱妻啊   | 爱妻啊  | 艾奇啊  | 艾琪啊  | 嗳气啊  | 爱奇啊  | 哀戚啊  | 哀泣啊  | 哎卡  | 爱卡  | 唉卡  | 艾卡  | 埃卡  | 矮卡  | 挨卡  | 哀卡  | 
aiqian | 爱钱   | 癌前   | 爱妻按  | 艾奇按  | 艾琪按  | 嗳气按  | 爱奇按  | 哀戚按  | 哀泣按  | 哎前  | 爱前  | 唉前  | 艾前  | 埃前  | 矮前  | 挨前  | 
aiqiang | 矮墙   | 爱墙   | 爱妻昂  | 艾奇昂  | 艾琪昂  | 嗳气昂  | 爱奇昂  | 哀戚昂  | 哀泣昂  | 哎强  | 爱强  | 唉强  | 艾强  | 埃强  | 矮强  | 挨强  | 
aiqiao | 爱桥   | 埃奇奥   | 爱妻奥  | 艾奇奥  | 艾琪奥  | 嗳气奥  | 爱奇奥  | 哀戚奥  | 哀泣奥  | 哎桥  | 爱桥  | 唉桥  | 艾桥  | 埃桥  | 矮桥  | 挨桥  | 
aiqie | 哀切   | 爱妻二  | 艾奇二  | 艾琪二  | 嗳气二  | 爱奇二  | 哀戚二  | 哀泣二  | 哎且  | 爱且  | 唉且  | 艾且  | 埃且  | 矮且  | 挨且  | 哀且  | 
aiqin | 爱琴   | 爱亲   | 爱情   | 哎亲  | 爱亲  | 唉亲  | 艾亲  | 埃亲  | 矮亲  | 挨亲  | 哀亲  | 癌亲  | 欸亲  | 嗳亲  | 碍亲  | 暧亲  | 
aiqing | 爱情   | 爱卿   | 艾青   | 爱清   | ❤   | 哎请  | 爱请  | 唉请  | 艾请  | 埃请  | 矮请  | 挨请  | 哀请  | 癌请  | 欸请  | 嗳请  | 
aiqiong | 矮穷   | 哎穷  | 爱穷  | 唉穷  | 艾穷  | 埃穷  | 矮穷  | 挨穷  | 哀穷  | 癌穷  | 欸穷  | 嗳穷  | 碍穷  | 暧穷  | 蔼穷  | 霭穷  | 
aiqiu | 哀求   | 挨球   | 爱囚   | 哎求  | 爱求  | 唉求  | 艾求  | 埃求  | 矮求  | 挨求  | 哀求  | 癌求  | 欸求  | 嗳求  | 碍求  | 暧求  | 
aiqu | 爱去   | 爱趣   | 哎去  | 爱去  | 唉去  | 艾去  | 埃去  | 矮去  | 挨去  | 哀去  | 癌去  | 欸去  | 嗳去  | 碍去  | 暧去  | 蔼去  | 
aiquan | 爱犬   | 爱去按  | 爱趣按  | 哎全  | 爱全  | 唉全  | 艾全  | 埃全  | 矮全  | 挨全  | 哀全  | 癌全  | 欸全  | 嗳全  | 碍全  | 暧全  | 
aique | 爱却   | 爱去二  | 爱趣二  | 哎却  | 爱却  | 唉却  | 艾却  | 埃却  | 矮却  | 挨却  | 哀却  | 癌却  | 欸却  | 嗳却  | 碍却  | 暧却  | 
aiqun | 爱群   | 哎群  | 爱群  | 唉群  | 艾群  | 埃群  | 矮群  | 挨群  | 哀群  | 癌群  | 欸群  | 嗳群  | 碍群  | 暧群  | 蔼群  | 霭群  | 
airan | 蔼然   | 哎然  | 爱然  | 唉然  | 艾然  | 埃然  | 矮然  | 挨然  | 哀然  | 癌然  | 欸然  | 嗳然  | 碍然  | 暧然  | 蔼然  | 霭然  | 
airang | 爱让   | 哎让  | 爱让  | 唉让  | 艾让  | 埃让  | 矮让  | 挨让  | 哀让  | 癌让  | 欸让  | 嗳让  | 碍让  | 暧让  | 蔼让  | 霭让  | 
airao | 爱绕   | 爱让哦  | 蔼然哦  | 哎绕  | 爱绕  | 唉绕  | 艾绕  | 埃绕  | 矮绕  | 挨绕  | 哀绕  | 癌绕  | 欸绕  | 嗳绕  | 碍绕  | 暧绕  | 
aire | 哎惹   | 爱了   | aired   | 哎热  | 爱热  | 唉热  | 艾热  | 埃热  | 矮热  | 挨热  | 哀热  | 癌热  | 欸热  | 嗳热  | 碍热  | 暧热  | 
airen | 爱人   | 矮人   | 哎人  | 爱人  | 唉人  | 艾人  | 埃人  | 矮人  | 挨人  | 哀人  | 癌人  | 欸人  | 嗳人  | 碍人  | 暧人  | 蔼人  | 
aireng | 爱仍   | 爱人   | 哎仍  | 爱仍  | 唉仍  | 艾仍  | 埃仍  | 矮仍  | 挨仍  | 哀仍  | 癌仍  | 欸仍  | 嗳仍  | 碍仍  | 暧仍  | 蔼仍  | 
airi | airing   | 艾莉   | 哎日  | 爱日  | 唉日  | 艾日  | 埃日  | 矮日  | 挨日  | 哀日  | 癌日  | 欸日  | 嗳日  | 碍日  | 暧日  | 蔼日  | 
airong | 艾绒   | 哀荣   | 哎容  | 爱容  | 唉容  | 艾容  | 埃容  | 矮容  | 挨容  | 哀容  | 癌容  | 欸容  | 嗳容  | 碍容  | 暧容  | 蔼容  | 
airou | 爱柔   | 哎肉  | 爱肉  | 唉肉  | 艾肉  | 埃肉  | 矮肉  | 挨肉  | 哀肉  | 癌肉  | 欸肉  | 嗳肉  | 碍肉  | 暧肉  | 蔼肉  | 霭肉  | 
airu | 爱如   | 艾如   | 哎如  | 爱如  | 唉如  | 艾如  | 埃如  | 矮如  | 挨如  | 哀如  | 癌如  | 欸如  | 嗳如  | 碍如  | 暧如  | 蔼如  | 
airua | 爱如啊   | 爱如啊  | 艾如啊  | 哎挼  | 爱挼  | 唉挼  | 艾挼  | 埃挼  | 矮挼  | 挨挼  | 哀挼  | 癌挼  | 欸挼  | 嗳挼  | 碍挼  | 暧挼  | 
airuan | 爱软   | 爱如按  | 艾如按  | 哎软  | 爱软  | 唉软  | 艾软  | 埃软  | 矮软  | 挨软  | 哀软  | 癌软  | 欸软  | 嗳软  | 碍软  | 暧软  | 
airui | 艾瑞   | 艾睿   | 哎瑞  | 爱瑞  | 唉瑞  | 艾瑞  | 埃瑞  | 矮瑞  | 挨瑞  | 哀瑞  | 癌瑞  | 欸瑞  | 嗳瑞  | 碍瑞  | 暧瑞  | 蔼瑞  | 
airun | 爱润   | 艾伦   | 哎润  | 爱润  | 唉润  | 艾润  | 埃润  | 矮润  | 挨润  | 哀润  | 癌润  | 欸润  | 嗳润  | 碍润  | 暧润  | 蔼润  | 
airuo | 爱若   | 爱如哦  | 艾如哦  | 哎若  | 爱若  | 唉若  | 艾若  | 埃若  | 矮若  | 挨若  | 哀若  | 癌若  | 欸若  | 嗳若  | 碍若  | 暧若  | 
aisa | 艾萨   | 哎撒  | 爱撒  | 唉撒  | 艾撒  | 埃撒  | 矮撒  | 挨撒  | 哀撒  | 癌撒  | 欸撒  | 嗳撒  | 碍撒  | 暧撒  | 蔼撒  | 霭撒  | 
aisai | 埃塞   | 哎赛  | 爱赛  | 唉赛  | 艾赛  | 埃赛  | 矮赛  | 挨赛  | 哀赛  | 癌赛  | 欸赛  | 嗳赛  | 碍赛  | 暧赛  | 蔼赛  | 霭赛  | 
aisan | 艾散   | 哎三  | 爱三  | 唉三  | 艾三  | 埃三  | 矮三  | 挨三  | 哀三  | 癌三  | 欸三  | 嗳三  | 碍三  | 暧三  | 蔼三  | 霭三  | 
aisang | 爱桑   | 爱上   | 哎桑  | 爱桑  | 唉桑  | 艾桑  | 埃桑  | 矮桑  | 挨桑  | 哀桑  | 癌桑  | 欸桑  | 嗳桑  | 碍桑  | 暧桑  | 蔼桑  | 
aisao | 爱扫   | 艾萨哦  | 哎扫  | 爱扫  | 唉扫  | 艾扫  | 埃扫  | 矮扫  | 挨扫  | 哀扫  | 癌扫  | 欸扫  | 嗳扫  | 碍扫  | 暧扫  | 蔼扫  | 
aise | 爱色   | 哎色  | 爱色  | 唉色  | 艾色  | 埃色  | 矮色  | 挨色  | 哀色  | 癌色  | 欸色  | 嗳色  | 碍色  | 暧色  | 蔼色  | 霭色  | 
aisen | 艾森   | 埃森   | 爱森   | 哎森  | 爱森  | 唉森  | 艾森  | 埃森  | 矮森  | 挨森  | 哀森  | 癌森  | 欸森  | 嗳森  | 碍森  | 暧森  | 
aiseng | 爱僧   | 哎僧  | 爱僧  | 唉僧  | 艾僧  | 埃僧  | 矮僧  | 挨僧  | 哀僧  | 癌僧  | 欸僧  | 嗳僧  | 碍僧  | 暧僧  | 蔼僧  | 霭僧  | 
aisha | 艾莎   | 爱莎   | 爱杀   | 哎啥   | 哎啥  | 爱啥  | 唉啥  | 艾啥  | 埃啥  | 矮啥  | 挨啥  | 哀啥  | 癌啥  | 欸啥  | 嗳啥  | 碍啥  | 
aishai | 挨晒   | 哎晒  | 爱晒  | 唉晒  | 艾晒  | 埃晒  | 矮晒  | 挨晒  | 哀晒  | 癌晒  | 欸晒  | 嗳晒  | 碍晒  | 暧晒  | 蔼晒  | 霭晒  | 
aishan | 爱山   | 艾山   | 爱上   | 哎山  | 爱山  | 唉山  | 艾山  | 埃山  | 矮山  | 挨山  | 哀山  | 癌山  | 欸山  | 嗳山  | 碍山  | 暧山  | 
aishang | 爱上   | 哀伤   | 爱尚   | 挨上   | /_ \   | 艾尚   | 爱殇   | 哎上  | 爱上  | 唉上  | 艾上  | 埃上  | 矮上  | 挨上  | 哀上  | 癌上  | 
aishao | 爱少   | 艾莎哦  | 爱莎哦  | 爱杀哦  | 哎啥哦  | 哎少  | 爱少  | 唉少  | 艾少  | 埃少  | 矮少  | 挨少  | 哀少  | 癌少  | 欸少  | 嗳少  | 
aishe | 爱舍   | 爱射   | 哎设  | 爱设  | 唉设  | 艾设  | 埃设  | 矮设  | 挨设  | 哀设  | 癌设  | 欸设  | 嗳设  | 碍设  | 暧设  | 蔼设  | 
aishei | 爱谁   | 哎谁  | 爱谁  | 唉谁  | 艾谁  | 埃谁  | 矮谁  | 挨谁  | 哀谁  | 癌谁  | 欸谁  | 嗳谁  | 碍谁  | 暧谁  | 蔼谁  | 霭谁  | 
aishen | 爱神   | 埃神   | 哎神  | 爱神  | 唉神  | 艾神  | 埃神  | 矮神  | 挨神  | 哀神  | 癌神  | 欸神  | 嗳神  | 碍神  | 暧神  | 蔼神  | 
aisheng | 爱生   | 哀声   | 唉声   | 哎生  | 爱生  | 唉生  | 艾生  | 埃生  | 矮生  | 挨生  | 哀生  | 癌生  | 欸生  | 嗳生  | 碍生  | 暧生  | 
aishi | 爱是   | 碍事   | 爱视   | 爱仕   | 艾什   | 哎是  | 爱是  | 唉是  | 艾是  | 埃是  | 矮是  | 挨是  | 哀是  | 癌是  | 欸是  | 嗳是  | 
aishou | 碍手   | 哎收  | 爱收  | 唉收  | 艾收  | 埃收  | 矮收  | 挨收  | 哀收  | 癌收  | 欸收  | 嗳收  | 碍收  | 暧收  | 蔼收  | 霭收  | 
aishu | 爱书   | 爱数   | 艾数   | 哎书  | 爱书  | 唉书  | 艾书  | 埃书  | 矮书  | 挨书  | 哀书  | 癌书  | 欸书  | 嗳书  | 碍书  | 暧书  | 
aishua | 爱耍   | 爱书啊  | 爱数啊  | 艾数啊  | 哎刷  | 爱刷  | 唉刷  | 艾刷  | 埃刷  | 矮刷  | 挨刷  | 哀刷  | 癌刷  | 欸刷  | 嗳刷  | 碍刷  | 
aishuai | 爱帅   | 爱书哎  | 爱数哎  | 艾数哎  | 哎帅  | 爱帅  | 唉帅  | 艾帅  | 埃帅  | 矮帅  | 挨帅  | 哀帅  | 癌帅  | 欸帅  | 嗳帅  | 碍帅  | 
aishuan | 癌栓   | 爱书按  | 爱数按  | 艾数按  | 哎栓  | 爱栓  | 唉栓  | 艾栓  | 埃栓  | 矮栓  | 挨栓  | 哀栓  | 癌栓  | 欸栓  | 嗳栓  | 碍栓  | 
aishuang | 哀霜   | 爱书昂  | 爱数昂  | 艾数昂  | 哎双  | 爱双  | 唉双  | 艾双  | 埃双  | 矮双  | 挨双  | 哀双  | 癌双  | 欸双  | 嗳双  | 碍双  | 
aishui | 爱谁   | 爱睡   | 爱水   | 哎谁  | 爱谁  | 唉谁  | 艾谁  | 埃谁  | 矮谁  | 挨谁  | 哀谁  | 癌谁  | 欸谁  | 嗳谁  | 碍谁  | 暧谁  | 
aishun | 爱顺   | 哎顺  | 爱顺  | 唉顺  | 艾顺  | 埃顺  | 矮顺  | 挨顺  | 哀顺  | 癌顺  | 欸顺  | 嗳顺  | 碍顺  | 暧顺  | 蔼顺  | 霭顺  | 
aishuo | 爱说   | 挨说   | 爱书哦  | 爱数哦  | 艾数哦  | 哎说  | 爱说  | 唉说  | 艾说  | 埃说  | 矮说  | 挨说  | 哀说  | 癌说  | 欸说  | 嗳说  | 
aisi | 埃斯   | 爱死   | 艾斯   | 爱思   | 哀思   | 爱丝   | 艾思   | Aisin   | 哎四  | 爱四  | 唉四  | 艾四  | 埃四  | 矮四  | 挨四  | 哀四  | 
aisong | 埃松   | 哎送  | 爱送  | 唉送  | 艾送  | 埃送  | 矮送  | 挨送  | 哀送  | 癌送  | 欸送  | 嗳送  | 碍送  | 暧送  | 蔼送  | 霭送  | 
aisou | 爱搜   | 哎搜  | 爱搜  | 唉搜  | 艾搜  | 埃搜  | 矮搜  | 挨搜  | 哀搜  | 癌搜  | 欸搜  | 嗳搜  | 碍搜  | 暧搜  | 蔼搜  | 霭搜  | 
aisu | 哀诉   | 艾素   | 哎苏  | 爱苏  | 唉苏  | 艾苏  | 埃苏  | 矮苏  | 挨苏  | 哀苏  | 癌苏  | 欸苏  | 嗳苏  | 碍苏  | 暧苏  | 蔼苏  | 
aisuan | 嗳酸   | 哀诉按  | 艾素按  | 哎算  | 爱算  | 唉算  | 艾算  | 埃算  | 矮算  | 挨算  | 哀算  | 癌算  | 欸算  | 嗳算  | 碍算  | 暧算  | 
aisui | 爱随   | 哎随  | 爱随  | 唉随  | 艾随  | 埃随  | 矮随  | 挨随  | 哀随  | 癌随  | 欸随  | 嗳随  | 碍随  | 暧随  | 蔼随  | 霭随  | 
aisun | 爱孙   | 哎孙  | 爱孙  | 唉孙  | 艾孙  | 埃孙  | 矮孙  | 挨孙  | 哀孙  | 癌孙  | 欸孙  | 嗳孙  | 碍孙  | 暧孙  | 蔼孙  | 霭孙  | 
aisuo | 埃索   | 爱索   | 哀诉哦  | 艾素哦  | 哎所  | 爱所  | 唉所  | 艾所  | 埃所  | 矮所  | 挨所  | 哀所  | 癌所  | 欸所  | 嗳所  | 碍所  | 
aita | 爱他   | 爱她   | 爱它   | 埃塔   | 哎他  | 爱他  | 唉他  | 艾他  | 埃他  | 矮他  | 挨他  | 哀他  | 癌他  | 欸他  | 嗳他  | 碍他  | 
aitai | 艾泰   | 埃泰   | 哎太  | 爱太  | 唉太  | 艾太  | 埃太  | 矮太  | 挨太  | 哀太  | 癌太  | 欸太  | 嗳太  | 碍太  | 暧太  | 蔼太  | 
aitan | 哀叹   | 艾坦   | 哎谈  | 爱谈  | 唉谈  | 艾谈  | 埃谈  | 矮谈  | 挨谈  | 哀谈  | 癌谈  | 欸谈  | 嗳谈  | 碍谈  | 暧谈  | 蔼谈  | 
aitang | 埃唐   | 哎唐  | 爱唐  | 唉唐  | 艾唐  | 埃唐  | 矮唐  | 挨唐  | 哀唐  | 癌唐  | 欸唐  | 嗳唐  | 碍唐  | 暧唐  | 蔼唐  | 霭唐  | 
aitao | 爱淘   | 爱涛   | 爱他哦  | 爱她哦  | 爱它哦  | 埃塔哦  | 哎套  | 爱套  | 唉套  | 艾套  | 埃套  | 矮套  | 挨套  | 哀套  | 癌套  | 欸套  | 
aite | 艾特   | 埃特   | 爱特   | 哎特  | 爱特  | 唉特  | 艾特  | 埃特  | 矮特  | 挨特  | 哀特  | 癌特  | 欸特  | 嗳特  | 碍特  | 暧特  | 
aitei | 爱忒   | 哎忒  | 爱忒  | 唉忒  | 艾忒  | 埃忒  | 矮忒  | 挨忒  | 哀忒  | 癌忒  | 欸忒  | 嗳忒  | 碍忒  | 暧忒  | 蔼忒  | 霭忒  | 
aiteng | 爱腾   | 哎疼  | 爱疼  | 唉疼  | 艾疼  | 埃疼  | 矮疼  | 挨疼  | 哀疼  | 癌疼  | 欸疼  | 嗳疼  | 碍疼  | 暧疼  | 蔼疼  | 霭疼  | 
aiti | 挨踢   | 哀啼   | 哎提  | 爱提  | 唉提  | 艾提  | 埃提  | 矮提  | 挨提  | 哀提  | 癌提  | 欸提  | 嗳提  | 碍提  | 暧提  | 蔼提  | 
aitian | 爱田   | 挨踢按  | 哀啼按  | 哎天  | 爱天  | 唉天  | 艾天  | 埃天  | 矮天  | 挨天  | 哀天  | 癌天  | 欸天  | 嗳天  | 碍天  | 暧天  | 
aitiao | 艾条   | 挨踢奥  | 哀啼奥  | 哎条  | 爱条  | 唉条  | 艾条  | 埃条  | 矮条  | 挨条  | 哀条  | 癌条  | 欸条  | 嗳条  | 碍条  | 暧条  | 
aitie | 爱贴   | 挨踢二  | 哀啼二  | 哎贴  | 爱贴  | 唉贴  | 艾贴  | 埃贴  | 矮贴  | 挨贴  | 哀贴  | 癌贴  | 欸贴  | 嗳贴  | 碍贴  | 暧贴  | 
aiting | 爱听   | 哎听  | 爱听  | 唉听  | 艾听  | 埃听  | 矮听  | 挨听  | 哀听  | 癌听  | 欸听  | 嗳听  | 碍听  | 暧听  | 蔼听  | 霭听  | 
aitong | 哀痛   | 哀恸   | 癌痛   | 哎同  | 爱同  | 唉同  | 艾同  | 埃同  | 矮同  | 挨同  | 哀同  | 癌同  | 欸同  | 嗳同  | 碍同  | 暧同  | 
aitou | 爱头   | 哎头  | 爱头  | 唉头  | 艾头  | 埃头  | 矮头  | 挨头  | 哀头  | 癌头  | 欸头  | 嗳头  | 碍头  | 暧头  | 蔼头  | 霭头  | 
aitu | 爱徒   | 哎图  | 爱图  | 唉图  | 艾图  | 埃图  | 矮图  | 挨图  | 哀图  | 癌图  | 欸图  | 嗳图  | 碍图  | 暧图  | 蔼图  | 霭图  | 
aituan | 爱团   | 爱徒按  | 哎团  | 爱团  | 唉团  | 艾团  | 埃团  | 矮团  | 挨团  | 哀团  | 癌团  | 欸团  | 嗳团  | 碍团  | 暧团  | 蔼团  | 
aitui | 埃忒   | 哎退  | 爱退  | 唉退  | 艾退  | 埃退  | 矮退  | 挨退  | 哀退  | 癌退  | 欸退  | 嗳退  | 碍退  | 暧退  | 蔼退  | 霭退  | 
aitun | 爱屯   | 哎屯  | 爱屯  | 唉屯  | 艾屯  | 埃屯  | 矮屯  | 挨屯  | 哀屯  | 癌屯  | 欸屯  | 嗳屯  | 碍屯  | 暧屯  | 蔼屯  | 霭屯  | 
aituo | 艾拓   | 爱徒哦  | 哎托  | 爱托  | 唉托  | 艾托  | 埃托  | 矮托  | 挨托  | 哀托  | 癌托  | 欸托  | 嗳托  | 碍托  | 暧托  | 蔼托  | 
aiwa | 爱娃   | 艾娃   | 爱瓦   | 爱蛙   | 哎哇   | Aiwa   | 哎哇  | 爱哇  | 唉哇  | 艾哇  | 埃哇  | 矮哇  | 挨哇  | 哀哇  | 癌哇  | 欸哇  | 
aiwai | 爱外   | 哎外  | 爱外  | 唉外  | 艾外  | 埃外  | 矮外  | 挨外  | 哀外  | 癌外  | 欸外  | 嗳外  | 碍外  | 暧外  | 蔼外  | 霭外  | 
aiwan | 爱玩   | 哀婉   | 哎玩  | 爱玩  | 唉玩  | 艾玩  | 埃玩  | 矮玩  | 挨玩  | 哀玩  | 癌玩  | 欸玩  | 嗳玩  | 碍玩  | 暧玩  | 蔼玩  | 
aiwang | 哀王   | 爱玩   | 哎王  | 爱王  | 唉王  | 艾王  | 埃王  | 矮王  | 挨王  | 哀王  | 癌王  | 欸王  | 嗳王  | 碍王  | 暧王  | 蔼王  | 
aiwei | 艾薇   | 艾维   | 艾威   | 爱为   | 爱维   | 爱威   | 艾伟   | 爱伟   | 哎为  | 爱为  | 唉为  | 艾为  | 埃为  | 矮为  | 挨为  | 哀为  | 
aiwen | 爱问   | 艾文   | 埃文   | 爱文   | 埃温   | 哎问  | 爱问  | 唉问  | 艾问  | 埃问  | 矮问  | 挨问  | 哀问  | 癌问  | 欸问  | 嗳问  | 
aiweng | 艾翁   | 哎翁  | 爱翁  | 唉翁  | 艾翁  | 埃翁  | 矮翁  | 挨翁  | 哀翁  | 癌翁  | 欸翁  | 嗳翁  | 碍翁  | 暧翁  | 蔼翁  | 霭翁  | 
aiwo | 爱我   | 哎我   | 挨我   | 哎我  | 爱我  | 唉我  | 艾我  | 埃我  | 矮我  | 挨我  | 哀我  | 癌我  | 欸我  | 嗳我  | 碍我  | 暧我  | 
aiwong | 爱我那个   | 爱我那个  | 哎我那个  | 挨我那个  | 哎我那个  | 爱我那个  | 唉我那个  | 艾我那个  | 埃我那个  | 矮我那个  | 挨我那个  | 哀我那个  | 癌我那个  | 欸我那个  | 嗳我那个  | 碍我那个  | 
aiwu | 爱屋   | 爱物   | 爱吾   | 哎五  | 爱五  | 唉五  | 艾五  | 埃五  | 矮五  | 挨五  | 哀五  | 癌五  | 欸五  | 嗳五  | 碍五  | 暧五  | 
aixi | 爱惜   | 艾希   | 埃希   | 艾西   | 爱喜   | 哎西   | 爱希   | 哎西  | 爱西  | 唉西  | 艾西  | 埃西  | 矮西  | 挨西  | 哀西  | 癌西  | 
aixia | 爱霞   | 爱夏   | 爱惜啊  | 艾希啊  | 埃希啊  | 艾西啊  | 爱喜啊  | 哎西啊  | 爱希啊  | 哎下  | 爱下  | 唉下  | 艾下  | 埃下  | 矮下  | 挨下  | 
aixian | 爱现   | 爱惜按  | 艾希按  | 埃希按  | 艾西按  | 爱喜按  | 哎西按  | 爱希按  | 哎先  | 爱先  | 唉先  | 艾先  | 埃先  | 矮先  | 挨先  | 哀先  | 
aixiang | 爱香   | 爱想   | 爱享   | 爱惜昂  | 艾希昂  | 埃希昂  | 艾西昂  | 爱喜昂  | 哎西昂  | 爱希昂  | 哎想  | 爱想  | 唉想  | 艾想  | 埃想  | 矮想  | 
aixiao | 爱笑   | 矮小   | 爱校   | 爱霞哦  | 爱夏哦  | 爱惜奥  | 艾希奥  | 埃希奥  | 艾西奥  | 爱喜奥  | 哎西奥  | 爱希奥  | 哎小  | 爱小  | 唉小  | 艾小  | 
aixie | 爱写   | 爱惜二  | 艾希二  | 埃希二  | 艾西二  | 爱喜二  | 哎西二  | 爱希二  | 哎写  | 爱写  | 唉写  | 艾写  | 埃写  | 矮写  | 挨写  | 哀写  | 
aixin | 爱心   | 埃辛   | 爱信   | 爱新   | ❤   | 艾欣   | 哎新  | 爱新  | 唉新  | 艾新  | 埃新  | 矮新  | 挨新  | 哀新  | 癌新  | 欸新  | 
aixing | 矮星   | 癌性   | 哎行  | 爱行  | 唉行  | 艾行  | 埃行  | 矮行  | 挨行  | 哀行  | 癌行  | 欸行  | 嗳行  | 碍行  | 暧行  | 蔼行  | 
aixiong | 挨熊   | 哎熊  | 爱熊  | 唉熊  | 艾熊  | 埃熊  | 矮熊  | 挨熊  | 哀熊  | 癌熊  | 欸熊  | 嗳熊  | 碍熊  | 暧熊  | 蔼熊  | 霭熊  | 
aixiu | 爱秀   | 哎修  | 爱修  | 唉修  | 艾修  | 埃修  | 矮修  | 挨修  | 哀修  | 癌修  | 欸修  | 嗳修  | 碍修  | 暧修  | 蔼修  | 霭修  | 
aixu | 爱旭   | 哎徐  | 爱徐  | 唉徐  | 艾徐  | 埃徐  | 矮徐  | 挨徐  | 哀徐  | 癌徐  | 欸徐  | 嗳徐  | 碍徐  | 暧徐  | 蔼徐  | 霭徐  | 
aixuan | 艾炫   | 爱旭按  | 哎选  | 爱选  | 唉选  | 艾选  | 埃选  | 矮选  | 挨选  | 哀选  | 癌选  | 欸选  | 嗳选  | 碍选  | 暧选  | 蔼选  | 
aixue | 爱学   | 爱雪   | 艾雪   | 爱旭二  | 哎学  | 爱学  | 唉学  | 艾学  | 埃学  | 矮学  | 挨学  | 哀学  | 癌学  | 欸学  | 嗳学  | 碍学  | 
aixun | 挨训   | 哎寻  | 爱寻  | 唉寻  | 艾寻  | 埃寻  | 矮寻  | 挨寻  | 哀寻  | 癌寻  | 欸寻  | 嗳寻  | 碍寻  | 暧寻  | 蔼寻  | 霭寻  | 
aiya | 哎呀   | 唉呀   | 爱呀   | 艾雅   | 爱雅   | 爱牙   | 爱鸭   | 哎呀  | 爱呀  | 唉呀  | 艾呀  | 埃呀  | 矮呀  | 挨呀  | 哀呀  | 癌呀  | 
aiyan | 碍眼   | 爱眼   | 哀艳   | 哎眼  | 爱眼  | 唉眼  | 艾眼  | 埃眼  | 矮眼  | 挨眼  | 哀眼  | 癌眼  | 欸眼  | 嗳眼  | 碍眼  | 暧眼  | 
aiyang | 爱养   | 哎杨  | 爱杨  | 唉杨  | 艾杨  | 埃杨  | 矮杨  | 挨杨  | 哀杨  | 癌杨  | 欸杨  | 嗳杨  | 碍杨  | 暧杨  | 蔼杨  | 霭杨  | 
aiyao | 爱要   | 哎吆   | 哎呀哦  | 唉呀哦  | 爱呀哦  | 艾雅哦  | 爱雅哦  | 爱牙哦  | 爱鸭哦  | 哎要  | 爱要  | 唉要  | 艾要  | 埃要  | 矮要  | 挨要  | 
aiye | 艾叶   | 爱液   | 哎也  | 爱也  | 唉也  | 艾也  | 埃也  | 矮也  | 挨也  | 哀也  | 癌也  | 欸也  | 嗳也  | 碍也  | 暧也  | 蔼也  | 
aiyi | 爱意   | 爱衣   | 哎一  | 爱一  | 唉一  | 艾一  | 埃一  | 矮一  | 挨一  | 哀一  | 癌一  | 欸一  | 嗳一  | 碍一  | 暧一  | 蔼一  | 
aiyin | 艾因   | 爱因   | 爱音   | 哎因  | 爱因  | 唉因  | 艾因  | 埃因  | 矮因  | 挨因  | 哀因  | 癌因  | 欸因  | 嗳因  | 碍因  | 暧因  | 
aiying | 爱婴   | 爱英   | 爱盈   | 哎应  | 爱应  | 唉应  | 艾应  | 埃应  | 矮应  | 挨应  | 哀应  | 癌应  | 欸应  | 嗳应  | 碍应  | 暧应  | 
aiyo | 哎哟   | 唉哟   | 哎唷   | 哎哟  | (￣y▽,￣)╭    | 爱哟  | 唉哟  | 艾哟  | 埃哟  | 矮哟  | 挨哟  | 哀哟  | 癌哟  | 欸哟  | 嗳哟  | 碍哟  | 
aiyong | 爱用   | 艾勇   | 哎用  | 爱用  | 唉用  | 艾用  | 埃用  | 矮用  | 挨用  | 哀用  | 癌用  | 欸用  | 嗳用  | 碍用  | 暧用  | 蔼用  | 
aiyou | 哎呦   | 矮油   | 爱有   | 爱幼   | 😏   | 爱游   | 哎有  | 爱有  | 唉有  | 艾有  | 埃有  | 矮有  | 挨有  | 哀有  | 癌有  | 欸有  | 
aiyu | 爱与   | 碍于   | 爱欲   | 爱玉   | 爱语   | 艾雨   | 爱鱼   | 哎与  | 爱与  | 唉与  | 艾与  | 埃与  | 矮与  | 挨与  | 哀与  | 癌与  | 
aiyuan | 哀怨   | 爱媛   | 爱源   | 爱与按  | 碍于按  | 爱欲按  | 爱玉按  | 爱语按  | 艾雨按  | 爱鱼按  | 哎元  | 爱元  | 唉元  | 艾元  | 埃元  | 矮元  | 
aiyue | 爱乐   | 哀乐   | 爱与二  | 碍于二  | 爱欲二  | 爱玉二  | 爱语二  | 艾雨二  | 爱鱼二  | 哎月  | 爱月  | 唉月  | 艾月  | 埃月  | 矮月  | 挨月  | 
aiyun | 爱云   | 艾云   | 哎云  | 爱云  | 唉云  | 艾云  | 埃云  | 矮云  | 挨云  | 哀云  | 癌云  | 欸云  | 嗳云  | 碍云  | 暧云  | 蔼云  | 
aiza | 爱咋   | 哎咋  | 爱咋  | 唉咋  | 艾咋  | 埃咋  | 矮咋  | 挨咋  | 哀咋  | 癌咋  | 欸咋  | 嗳咋  | 碍咋  | 暧咋  | 蔼咋  | 霭咋  | 
aizai | 爱在   | 哀哉   | 挨宰   | 挨在   | 哎在  | 爱在  | 唉在  | 艾在  | 埃在  | 矮在  | 挨在  | 哀在  | 癌在  | 欸在  | 嗳在  | 碍在  | 
aizan | 爱赞   | 哎赞  | 爱赞  | 唉赞  | 艾赞  | 埃赞  | 矮赞  | 挨赞  | 哀赞  | 癌赞  | 欸赞  | 嗳赞  | 碍赞  | 暧赞  | 蔼赞  | 霭赞  | 
aizang | 爱藏   | 哎藏  | 爱藏  | 唉藏  | 艾藏  | 埃藏  | 矮藏  | 挨藏  | 哀藏  | 癌藏  | 欸藏  | 嗳藏  | 碍藏  | 暧藏  | 蔼藏  | 霭藏  | 
aizao | 爱枣   | 爱咋哦  | 哎早  | 爱早  | 唉早  | 艾早  | 埃早  | 矮早  | 挨早  | 哀早  | 癌早  | 欸早  | 嗳早  | 碍早  | 暧早  | 蔼早  | 
aize | 艾泽   | 爱着   | 哎则  | 爱则  | 唉则  | 艾则  | 埃则  | 矮则  | 挨则  | 哀则  | 癌则  | 欸则  | 嗳则  | 碍则  | 暧则  | 蔼则  | 
aizei | 爱贼   | 哎贼  | 爱贼  | 唉贼  | 艾贼  | 埃贼  | 矮贼  | 挨贼  | 哀贼  | 癌贼  | 欸贼  | 嗳贼  | 碍贼  | 暧贼  | 蔼贼  | 霭贼  | 
aizen | 爱怎   | 哎怎  | 爱怎  | 唉怎  | 艾怎  | 埃怎  | 矮怎  | 挨怎  | 哀怎  | 癌怎  | 欸怎  | 嗳怎  | 碍怎  | 暧怎  | 蔼怎  | 霭怎  | 
aizeng | 爱憎   | 哎曾  | 爱曾  | 唉曾  | 艾曾  | 埃曾  | 矮曾  | 挨曾  | 哀曾  | 癌曾  | 欸曾  | 嗳曾  | 碍曾  | 暧曾  | 蔼曾  | 霭曾  | 
aizha | 挨炸   | 哎炸  | 爱炸  | 唉炸  | 艾炸  | 埃炸  | 矮炸  | 挨炸  | 哀炸  | 癌炸  | 欸炸  | 嗳炸  | 碍炸  | 暧炸  | 蔼炸  | 霭炸  | 
aizhai | 矮寨   | 哎宅  | 爱宅  | 唉宅  | 艾宅  | 埃宅  | 矮宅  | 挨宅  | 哀宅  | 癌宅  | 欸宅  | 嗳宅  | 碍宅  | 暧宅  | 蔼宅  | 霭宅  | 
aizhan | 爱占   | 爱站   | 哎站  | 爱站  | 唉站  | 艾站  | 埃站  | 矮站  | 挨站  | 哀站  | 癌站  | 欸站  | 嗳站  | 碍站  | 暧站  | 蔼站  | 
aizhang | 爱张   | 哎张  | 爱张  | 唉张  | 艾张  | 埃张  | 矮张  | 挨张  | 哀张  | 癌张  | 欸张  | 嗳张  | 碍张  | 暧张  | 蔼张  | 霭张  | 
aizhao | 爱找   | 哎找  | 爱找  | 唉找  | 艾找  | 埃找  | 矮找  | 挨找  | 哀找  | 癌找  | 欸找  | 嗳找  | 碍找  | 暧找  | 蔼找  | 霭找  | 
aizhe | 爱着   | 挨着   | 碍着   | 哎这  | 爱这  | 唉这  | 艾这  | 埃这  | 矮这  | 挨这  | 哀这  | 癌这  | 欸这  | 嗳这  | 碍这  | 暧这  | 
aizhei | 爱这   | 哎这  | 爱这  | 唉这  | 艾这  | 埃这  | 矮这  | 挨这  | 哀这  | 癌这  | 欸这  | 嗳这  | 碍这  | 暧这  | 蔼这  | 霭这  | 
aizhen | 爱珍   | 哎真  | 爱真  | 唉真  | 艾真  | 埃真  | 矮真  | 挨真  | 哀真  | 癌真  | 欸真  | 嗳真  | 碍真  | 暧真  | 蔼真  | 霭真  | 
aizheng | 癌症   | 挨整   | 哎正  | 爱正  | 唉正  | 艾正  | 埃正  | 矮正  | 挨正  | 哀正  | 癌正  | 欸正  | 嗳正  | 碍正  | 暧正  | 蔼正  | 
aizhi | 爱之   | 爱知   | 哎之  | 爱之  | 唉之  | 艾之  | 埃之  | 矮之  | 挨之  | 哀之  | 癌之  | 欸之  | 嗳之  | 碍之  | 暧之  | 蔼之  | 
aizhong | 爱中   | 癌肿   | 爱众   | 哎中  | 爱中  | 唉中  | 艾中  | 埃中  | 矮中  | 挨中  | 哀中  | 癌中  | 欸中  | 嗳中  | 碍中  | 暧中  | 
aizhou | 爱周   | 哎周  | 爱周  | 唉周  | 艾周  | 埃周  | 矮周  | 挨周  | 哀周  | 癌周  | 欸周  | 嗳周  | 碍周  | 暧周  | 蔼周  | 霭周  | 
aizhu | 爱珠   | 爱主   | 艾柱   | 爱猪   | 哎住  | 爱住  | 唉住  | 艾住  | 埃住  | 矮住  | 挨住  | 哀住  | 癌住  | 欸住  | 嗳住  | 碍住  | 
aizhua | 挨抓   | 爱珠啊  | 爱主啊  | 艾柱啊  | 爱猪啊  | 哎抓  | 爱抓  | 唉抓  | 艾抓  | 埃抓  | 矮抓  | 挨抓  | 哀抓  | 癌抓  | 欸抓  | 嗳抓  | 
aizhuai | 爱拽   | 爱珠哎  | 爱主哎  | 艾柱哎  | 爱猪哎  | 哎拽  | 爱拽  | 唉拽  | 艾拽  | 埃拽  | 矮拽  | 挨拽  | 哀拽  | 癌拽  | 欸拽  | 嗳拽  | 
aizhuan | 挨砖   | 爱珠按  | 爱主按  | 艾柱按  | 爱猪按  | 哎转  | 爱转  | 唉转  | 艾转  | 埃转  | 矮转  | 挨转  | 哀转  | 癌转  | 欸转  | 嗳转  | 
aizhuang | 爱装   | 爱珠昂  | 爱主昂  | 艾柱昂  | 爱猪昂  | 哎装  | 爱装  | 唉装  | 艾装  | 埃装  | 矮装  | 挨装  | 哀装  | 癌装  | 欸装  | 嗳装  | 
aizhui | 爱追   | 哎追  | 爱追  | 唉追  | 艾追  | 埃追  | 矮追  | 挨追  | 哀追  | 癌追  | 欸追  | 嗳追  | 碍追  | 暧追  | 蔼追  | 霭追  | 
aizhun | 爱准   | 哎准  | 爱准  | 唉准  | 艾准  | 埃准  | 矮准  | 挨准  | 哀准  | 癌准  | 欸准  | 嗳准  | 碍准  | 暧准  | 蔼准  | 霭准  | 
aizhuo | 艾卓   | 爱珠哦  | 爱主哦  | 艾柱哦  | 爱猪哦  | 哎卓  | 爱卓  | 唉卓  | 艾卓  | 埃卓  | 矮卓  | 挨卓  | 哀卓  | 癌卓  | 欸卓  | 嗳卓  | 
aizi | 矮子   | 艾滋   | 爱子   | 哎子  | 爱子  | 唉子  | 艾子  | 埃子  | 矮子  | 挨子  | 哀子  | 癌子  | 欸子  | 嗳子  | 碍子  | 暧子  | 
aizong | 艾总   | 爱总   | 哎总  | 爱总  | 唉总  | 艾总  | 埃总  | 矮总  | 挨总  | 哀总  | 癌总  | 欸总  | 嗳总  | 碍总  | 暧总  | 蔼总  | 
aizou | 挨揍   | 爱走   | 哎走  | 爱走  | 唉走  | 艾走  | 埃走  | 矮走  | 挨走  | 哀走  | 癌走  | 欸走  | 嗳走  | 碍走  | 暧走  | 蔼走  | 
aizu | 矮族   | 哎组  | 爱组  | 唉组  | 艾组  | 埃组  | 矮组  | 挨组  | 哀组  | 癌组  | 欸组  | 嗳组  | 碍组  | 暧组  | 蔼组  | 霭组  | 
aizuan | 爱钻   | 哎钻  | 爱钻  | 唉钻  | 艾钻  | 埃钻  | 矮钻  | 挨钻  | 哀钻  | 癌钻  | 欸钻  | 嗳钻  | 碍钻  | 暧钻  | 蔼钻  | 霭钻  | 
aizui | 爱最   | 哎最  | 爱最  | 唉最  | 艾最  | 埃最  | 矮最  | 挨最  | 哀最  | 癌最  | 欸最  | 嗳最  | 碍最  | 暧最  | 蔼最  | 霭最  | 
aizun | 爱尊   | 哎尊  | 爱尊  | 唉尊  | 艾尊  | 埃尊  | 矮尊  | 挨尊  | 哀尊  | 癌尊  | 欸尊  | 嗳尊  | 碍尊  | 暧尊  | 蔼尊  | 霭尊  | 
aizuo | 爱做   | 哎做  | 爱做  | 唉做  | 艾做  | 埃做  | 矮做  | 挨做  | 哀做  | 癌做  | 欸做  | 嗳做  | 碍做  | 暧做  | 蔼做  | 霭做  | 
ana | 阿纳   | 啊那   | 阿娜   | 婀娜   | 按啊  | 安啊  | 俺啊  | 案啊  | 暗啊  | 岸啊  | 庵啊  | 胺啊  | 氨啊  | 鞍啊  | 铵啊  | 黯啊  | 
anai | 阿奶   | 按哎  | 安哎  | 俺哎  | 案哎  | 暗哎  | 岸哎  | 庵哎  | 胺哎  | 氨哎  | 鞍哎  | 铵哎  | 黯哎  | 谙哎  | 桉哎  | 唵哎  | 
anan | 安安   | 爱你爱你爱你   | 暗暗   | 爱你爱你   | 按按   | 阿南   | 阿难   | 阿囡   | 荌荌   | 按按  | 安按  | 俺按  | 案按  | 暗按  | 岸按  | 庵按  | 
anang | 按昂   | 安安   | 按昂  | 安昂  | 俺昂  | 案昂  | 暗昂  | 岸昂  | 庵昂  | 胺昂  | 氨昂  | 鞍昂  | 铵昂  | 黯昂  | 谙昂  | 桉昂  | 
anao | 啊闹   | 阿纳哦  | 啊那哦  | 阿娜哦  | 婀娜哦  | 按奥  | 安奥  | 俺奥  | 案奥  | 暗奥  | 岸奥  | 庵奥  | 胺奥  | 氨奥  | 鞍奥  | 铵奥  | 
anba | 俺爸   | 安吧   | 安霸   | 按吧   | 按吧  | 安吧  | 俺吧  | 案吧  | 暗吧  | 岸吧  | 庵吧  | 胺吧  | 氨吧  | 鞍吧  | 铵吧  | 黯吧  | 
anbai | 安柏   | 安百   | 按白  | 安白  | 俺白  | 案白  | 暗白  | 岸白  | 庵白  | 胺白  | 氨白  | 鞍白  | 铵白  | 黯白  | 谙白  | 桉白  | 
anban | 案板   | 安办   | 俺班   | 暗斑   | 按版  | 安版  | 俺版  | 案版  | 暗版  | 岸版  | 庵版  | 胺版  | 氨版  | 鞍版  | 铵版  | 黯版  | 
anbang | 安邦   | 按帮  | 安帮  | 俺帮  | 案帮  | 暗帮  | 岸帮  | 庵帮  | 胺帮  | 氨帮  | 鞍帮  | 铵帮  | 黯帮  | 谙帮  | 桉帮  | 唵帮  | 
anbao | 安保   | 暗堡   | 安宝   | 安包   | 按包   | 俺爸哦  | 安吧哦  | 安霸哦  | 按吧哦  | 按包  | 安包  | 俺包  | 案包  | 暗包  | 岸包  | 庵包  | 
anbei | 安倍   | 安北   | 安贝   | 按被  | 安被  | 俺被  | 案被  | 暗被  | 岸被  | 庵被  | 胺被  | 氨被  | 鞍被  | 铵被  | 黯被  | 谙被  | 
anben | 岸本   | 按本   | 按本  | 安本  | 俺本  | 案本  | 暗本  | 岸本  | 庵本  | 胺本  | 氨本  | 鞍本  | 铵本  | 黯本  | 谙本  | 桉本  | 
anbeng | 按泵   | 按泵  | 安泵  | 俺泵  | 案泵  | 暗泵  | 岸泵  | 庵泵  | 胺泵  | 氨泵  | 鞍泵  | 铵泵  | 黯泵  | 谙泵  | 桉泵  | 唵泵  | 
anbi | 暗壁   | 鞍鼻   | 按比  | 安比  | 俺比  | 案比  | 暗比  | 岸比  | 庵比  | 胺比  | 氨比  | 鞍比  | 铵比  | 黯比  | 谙比  | 桉比  | 
anbian | 岸边   | 氨苄   | 暗壁按  | 鞍鼻按  | 按便  | 安便  | 俺便  | 案便  | 暗便  | 岸便  | 庵便  | 胺便  | 氨便  | 鞍便  | 铵便  | 黯便  | 
anbiang | 按变更   | 岸边   | 氨苄给  | 暗壁昂  | 鞍鼻昂  | 按变更  | 安变更  | 俺变更  | 案变更  | 暗变更  | 岸变更  | 庵变更  | 胺变更  | 氨变更  | 鞍变更  | 铵变更  | 
anbiao | 岸标   | 安标   | 暗标   | 按表   | 暗婊   | 暗壁奥  | 鞍鼻奥  | 按表  | 安表  | 俺表  | 案表  | 暗表  | 岸表  | 庵表  | 胺表  | 氨表  | 
anbie | 按别   | 暗壁二  | 鞍鼻二  | 按别  | 安别  | 俺别  | 案别  | 暗别  | 岸别  | 庵别  | 胺别  | 氨别  | 鞍别  | 铵别  | 黯别  | 谙别  | 
anbin | 安斌   | 按斌  | 安斌  | 俺斌  | 案斌  | 暗斌  | 岸斌  | 庵斌  | 胺斌  | 氨斌  | 鞍斌  | 铵斌  | 黯斌  | 谙斌  | 桉斌  | 唵斌  | 
anbing | 暗病   | 按并  | 安并  | 俺并  | 案并  | 暗并  | 岸并  | 庵并  | 胺并  | 氨并  | 鞍并  | 铵并  | 黯并  | 谙并  | 桉并  | 唵并  | 
anbo | 安博   | 安波   | 安播   | 按波  | 安波  | 俺波  | 案波  | 暗波  | 岸波  | 庵波  | 胺波  | 氨波  | 鞍波  | 铵波  | 黯波  | 谙波  | 
anbu | 暗部   | 俺不   | 安瓿   | 安部   | 庵埠   | 暗补   | 按不  | 安不  | 俺不  | 案不  | 暗不  | 岸不  | 庵不  | 胺不  | 氨不  | 鞍不  | 
anca | 按擦   | 按擦  | 安擦  | 俺擦  | 案擦  | 暗擦  | 岸擦  | 庵擦  | 胺擦  | 氨擦  | 鞍擦  | 铵擦  | 黯擦  | 谙擦  | 桉擦  | 唵擦  | 
ancai | 安财   | 安彩   | 按才  | 安才  | 俺才  | 案才  | 暗才  | 岸才  | 庵才  | 胺才  | 氨才  | 鞍才  | 铵才  | 黯才  | 谙才  | 桉才  | 
ancan | 按惨   | 暗藏   | 按惨  | 安惨  | 俺惨  | 案惨  | 暗惨  | 岸惨  | 庵惨  | 胺惨  | 氨惨  | 鞍惨  | 铵惨  | 黯惨  | 谙惨  | 桉惨  | 
ancang | 暗藏   | 暗舱   | 按仓  | 安仓  | 俺仓  | 案仓  | 暗仓  | 岸仓  | 庵仓  | 胺仓  | 氨仓  | 鞍仓  | 铵仓  | 黯仓  | 谙仓  | 桉仓  | 
ancao | 岸草   | 按操  | 安操  | 俺操  | 案操  | 暗操  | 岸操  | 庵操  | 胺操  | 氨操  | 鞍操  | 铵操  | 黯操  | 谙操  | 桉操  | 唵操  | 
ance | ancestors   | 按测  | 安测  | 俺测  | 案测  | 暗测  | 岸测  | 庵测  | 胺测  | 氨测  | 鞍测  | 铵测  | 黯测  | 谙测  | 桉测  | 唵测  | 
ancei | 安策i   | 按测i  | 安测i  | 俺测i  | 案测i  | 暗测i  | 岸测i  | 庵测i  | 胺测i  | 氨测i  | 鞍测i  | 铵测i  | 黯测i  | 谙测i  | 桉测i  | 唵测i  | 
ancen | 按岑   | 按岑  | 安岑  | 俺岑  | 案岑  | 暗岑  | 岸岑  | 庵岑  | 胺岑  | 氨岑  | 鞍岑  | 铵岑  | 黯岑  | 谙岑  | 桉岑  | 唵岑  | 
anceng | 按曾   | 按曾  | 安曾  | 俺曾  | 案曾  | 暗曾  | 岸曾  | 庵曾  | 胺曾  | 氨曾  | 鞍曾  | 铵曾  | 黯曾  | 谙曾  | 桉曾  | 唵曾  | 
ancha | 安插   | 按插   | 按差  | 安差  | 俺差  | 案差  | 暗差  | 岸差  | 庵差  | 胺差  | 氨差  | 鞍差  | 铵差  | 黯差  | 谙差  | 桉差  | 
anchai | 安拆   | 按拆  | 安拆  | 俺拆  | 案拆  | 暗拆  | 岸拆  | 庵拆  | 胺拆  | 氨拆  | 鞍拆  | 铵拆  | 黯拆  | 谙拆  | 桉拆  | 唵拆  | 
anchan | 安产   | 按产  | 安产  | 俺产  | 案产  | 暗产  | 岸产  | 庵产  | 胺产  | 氨产  | 鞍产  | 铵产  | 黯产  | 谙产  | 桉产  | 唵产  | 
anchang | 案场   | 安昌   | 暗娼   | 暗场   | 安畅   | 按长  | 安长  | 俺长  | 案长  | 暗长  | 岸长  | 庵长  | 胺长  | 氨长  | 鞍长  | 铵长  | 
anchao | 暗潮   | 安超   | 安插哦  | 按插哦  | 按超  | 安超  | 俺超  | 案超  | 暗超  | 岸超  | 庵超  | 胺超  | 氨超  | 鞍超  | 铵超  | 黯超  | 
anche | 岸澈   | 按车  | 安车  | 俺车  | 案车  | 暗车  | 岸车  | 庵车  | 胺车  | 氨车  | 鞍车  | 铵车  | 黯车  | 谙车  | 桉车  | 唵车  | 
anchen | 暗沉   | 安辰   | 安晨   | 按陈  | 安陈  | 俺陈  | 案陈  | 暗陈  | 岸陈  | 庵陈  | 胺陈  | 氨陈  | 鞍陈  | 铵陈  | 黯陈  | 谙陈  | 
ancheng | 安城   | 安成   | 按成   | 安诚   | 案秤   | 按成  | 安成  | 俺成  | 案成  | 暗成  | 岸成  | 庵成  | 胺成  | 氨成  | 鞍成  | 铵成  | 
anchi | 安驰   | 按吃  | 安吃  | 俺吃  | 案吃  | 暗吃  | 岸吃  | 庵吃  | 胺吃  | 氨吃  | 鞍吃  | 铵吃  | 黯吃  | 谙吃  | 桉吃  | 唵吃  | 
anchong | 安崇   | 按冲  | 安冲  | 俺冲  | 案冲  | 暗冲  | 岸冲  | 庵冲  | 胺冲  | 氨冲  | 鞍冲  | 铵冲  | 黯冲  | 谙冲  | 桉冲  | 唵冲  | 
anchou | 按抽   | 按抽  | 安抽  | 俺抽  | 案抽  | 暗抽  | 岸抽  | 庵抽  | 胺抽  | 氨抽  | 鞍抽  | 铵抽  | 黯抽  | 谙抽  | 桉抽  | 唵抽  | 
anchu | 暗处   | 安处   | 按出   | 按出  | 安出  | 俺出  | 案出  | 暗出  | 岸出  | 庵出  | 胺出  | 氨出  | 鞍出  | 铵出  | 黯出  | 谙出  | 
anchua | 暗处啊   | 暗处啊  | 安处啊  | 按出啊  | 按欻  | 安欻  | 俺欻  | 案欻  | 暗欻  | 岸欻  | 庵欻  | 胺欻  | 氨欻  | 鞍欻  | 铵欻  | 黯欻  | 
anchuai | 按踹   | 暗处哎  | 安处哎  | 按出哎  | 按踹  | 安踹  | 俺踹  | 案踹  | 暗踹  | 岸踹  | 庵踹  | 胺踹  | 氨踹  | 鞍踹  | 铵踹  | 黯踹  | 
anchuan | 安川   | 暗处按  | 安处按  | 按出按  | 按穿  | 安穿  | 俺穿  | 案穿  | 暗穿  | 岸穿  | 庵穿  | 胺穿  | 氨穿  | 鞍穿  | 铵穿  | 黯穿  | 
anchuang | 暗疮   | 安创   | 暗处昂  | 安处昂  | 按出昂  | 按床  | 安床  | 俺床  | 案床  | 暗床  | 岸床  | 庵床  | 胺床  | 氨床  | 鞍床  | 铵床  | 
anchui | 按吹   | 按吹  | 安吹  | 俺吹  | 案吹  | 暗吹  | 岸吹  | 庵吹  | 胺吹  | 氨吹  | 鞍吹  | 铵吹  | 黯吹  | 谙吹  | 桉吹  | 唵吹  | 
anchun | 鹌鹑   | 按春  | 安春  | 俺春  | 案春  | 暗春  | 岸春  | 庵春  | 胺春  | 氨春  | 鞍春  | 铵春  | 黯春  | 谙春  | 桉春  | 唵春  | 
anchuo | 暗处哦   | 按错   | 暗处哦  | 安处哦  | 按出哦  | 按戳  | 安戳  | 俺戳  | 案戳  | 暗戳  | 岸戳  | 庵戳  | 胺戳  | 氨戳  | 鞍戳  | 铵戳  | 
anci | 按此   | 按次   | 安次   | 安赐   | 暗刺   | ancient   | 按此  | 安此  | 俺此  | 案此  | 暗此  | 岸此  | 庵此  | 胺此  | 氨此  | 鞍此  | 
ancong | 俺从   | 按从  | 安从  | 俺从  | 案从  | 暗从  | 岸从  | 庵从  | 胺从  | 氨从  | 鞍从  | 铵从  | 黯从  | 谙从  | 桉从  | 唵从  | 
ancou | 按凑   | 按凑  | 安凑  | 俺凑  | 案凑  | 暗凑  | 岸凑  | 庵凑  | 胺凑  | 氨凑  | 鞍凑  | 铵凑  | 黯凑  | 谙凑  | 桉凑  | 唵凑  | 
ancu | 暗促   | 按粗  | 安粗  | 俺粗  | 案粗  | 暗粗  | 岸粗  | 庵粗  | 胺粗  | 氨粗  | 鞍粗  | 铵粗  | 黯粗  | 谙粗  | 桉粗  | 唵粗  | 
ancuan | 按窜   | 暗促按  | 按窜  | 安窜  | 俺窜  | 案窜  | 暗窜  | 岸窜  | 庵窜  | 胺窜  | 氨窜  | 鞍窜  | 铵窜  | 黯窜  | 谙窜  | 桉窜  | 
ancui | 按崔   | 按崔  | 安崔  | 俺崔  | 案崔  | 暗崔  | 岸崔  | 庵崔  | 胺崔  | 氨崔  | 鞍崔  | 铵崔  | 黯崔  | 谙崔  | 桉崔  | 唵崔  | 
ancun | 安村   | 俺村   | 按村  | 安村  | 俺村  | 案村  | 暗村  | 岸村  | 庵村  | 胺村  | 氨村  | 鞍村  | 铵村  | 黯村  | 谙村  | 桉村  | 
ancuo | 按错   | 安措   | 暗促哦  | 按错  | 安错  | 俺错  | 案错  | 暗错  | 岸错  | 岸错 | 庵错  | 胺错  | 氨错  | 鞍错  | 铵错  | 岸错  | 
anda | 安达   | 安打   | 安大   | 暗打   | Andalusia   | 安达   | 安达   | 安达   | 案大  | 安大  | 俺大  | 案大  | 暗大  | 岸大  | 庵大  | 按大  | 
andai | 暗袋   | 按带  | 安带  | 俺带  | 案带  | 暗带  | 岸带  | 暗袋   | 庵带  | 胺带  | 氨带  | 鞍带  | 铵带  | 黯带  | 桉带  | 胺带  | 
andan | 暗淡   | 黯淡   | 氨氮   | 按单   | andante   | 暗淡   | 暗淡   | 暗淡   | 案但  | 安但  | 岸但  | 案但  | 胺但  | 氨但  | 庵但  | 案但  | 
andang | 按当   | 暗淡   | 按当  | 安当  | 俺当  | 案当  | 按当   | 按当   | 暗当  | 岸当  | 庵当  | 鞍当  | 铵当  | 鞍当  | 谙当  | 庵当  | 
andao | 暗道   | 按倒   | 按到   | 安到   | 安道   | 按道   | 暗道   | 暗道   | 安打哦  | 安达哦  | 安打哦  | 按到  | 暗打哦  | 俺到  | 暗刀   | 暗刀   | 
ande | 俺的   | 安德   | 安的   | 安得   | 暗的   | 按的   | 俺的   | 俺的   | 按得   | Anderson   | 俺的  | 安的  | 暗的  | 案的  | 按得   | 按得   | 
andei | 俺得   | 按得  | 安得  | 俺得  | 案得  | 暗得  | 岸得  | 俺得   | 庵得  | 胺得  | 鞍得  | 铵得  | 铵得  | 黯得  | 桉得  | 庵得  | 
anden | 按扽   | 按扽  | 安扽  | 俺扽  | 案扽  | 暗扽  | 岸扽  | 按扽   | 庵扽  | 胺扽  | 鞍扽  | 鞍扽  | 黯扽  | 黯扽  | 桉扽  | 庵扽  | 
andeng | 安灯   | 暗灯   | 按灯   | 按等  | 安等  | 俺等  | 案等  | 安灯   | 岸等  | 岸等  | 庵等  | 胺等  | 鞍等  | 鞍等  | 黯等  | 暗等  | 
andi | 安迪   | 暗地   | 暗帝   | 俺滴   | 案底   | 安地   | 安迪   | 安迪   | andirons   | 按地   | andirons   | 俺地  | 案地  | 俺地  | 俺弟   | andirons   | 
andia | 安迪啊   | 安迪啊  | 暗地啊  | 暗帝啊  | 俺滴啊  | 安迪啊   | 安迪啊   | 安迪啊   | 案底啊  | 安地啊  | 俺弟啊  | 俺嗲  | 案嗲  | 暗嗲  | 岸嗲  | 按地啊  | 
andian | 暗点   | 按点   | 鞍点   | 暗殿   | 岸电   | 安迪按  | 暗点   | 暗点   | 俺滴按  | 暗帝按  | 俺滴按  | 案底按  | 按地按  | 按点  | 俺滴按  | 俺滴按  | 
andiao | 按掉   | 暗调   | 岸吊   | 安迪奥  | 暗地奥  | 暗帝奥  | 按掉   | 按掉   | 安地奥  | 俺弟奥  | 按地奥  | 俺弟奥  | 安掉  | 按掉  | 案掉  | 安地奥  | 
andie | 俺爹   | 安迪二  | 暗地二  | 暗帝二  | 俺滴二  | 案底二  | 俺爹   | 俺爹   | 安地二  | 俺弟二  | 按地二  | 按爹  | 案爹  | 俺爹  | 案爹  | 按地二  | 
andin | 安定   | 按顶  | 安顶  | 俺顶  | 案顶  | 暗顶  | 岸顶  | 安定   | 庵顶  | 胺顶  | 氨顶  | 鞍顶  | 铵顶  | 黯顶  | 桉顶  | 胺顶  | 
anding | 安定   | 按顶  | 安顶  | 俺顶  | 案顶  | 暗顶  | 岸顶  | 安定   | 庵顶  | 胺顶  | 氨顶  | 鞍顶  | 铵顶  | 黯顶  | 谙顶  | 胺顶  | 
andiu | 按丢   | 按丢  | 安丢  | 俺丢  | 案丢  | 暗丢  | 岸丢  | 按丢   | 庵丢  | 胺丢  | 氨丢  | 铵丢  | 铵丢  | 黯丢  | 谙丢  | 庵丢  | 
andong | 安东   | 按动   | 庵东   | 暗洞   | 按东  | 安东  | 安东   | 安东   | 暗东  | 案东  | 暗东  | 胺东  | 氨东  | 胺东  | 氨东  | 暗东  | 
andou | 俺都   | 暗斗   | 按都  | 安都  | 俺都  | 案都  | 暗都  | 俺都   | 岸都  | 胺都  | 胺都  | 鞍都  | 铵都  | 铵都  | 谙都  | 岸都  | 
andu | 安度   | 暗度   | 案牍   | 安堵   | 安杜   | 按都  | 安度   | 安度   | 安都  | 俺都  | 岸都  | 暗都  | 岸都  | 氨都  | 鞍都  | 安都  | 
anduan | 按段   | 安度按  | 暗度按  | 案牍按  | 安堵按  | 安杜按  | 按段   | 按段   | 按段  | 安段  | 俺段  | 案段  | 庵段  | 岸段  | 庵段  | 按段  | 
andui | 俺对   | 暗队   | 按对  | 安对  | 俺对  | 案对  | 暗对  | 俺对   | 岸对  | 胺对  | 氨对  | 氨对  | 鞍对  | 铵对  | 黯对  | 岸对  | 
andun | 安顿   | 暗盾   | 按吨   | 按吨  | 安吨  | 俺吨  | 案吨  | 安顿   | 暗吨  | 岸吨  | 庵吨  | 胺吨  | 氨吨  | 鞍吨  | 黯吨  | 暗吨  | 
anduo | 安多   | 安朵   | 按多   | 安度哦  | 暗度哦  | 案牍哦  | 安多   | 安多   | 按多  | 安多  | 俺多  | 安多  | 俺多  | 案多  | 庵多  | 按多  | 
ane | 阿讷   | 按二  | 安二  | 俺二  | 案二  | 暗二  | 岸二  | 阿讷   | 庵二  | 胺二  | 鞍二  | 鞍二  | 铵二  | 黯二  | 谙二  | 庵二  | 
anei | 阿内   | 按欸  | 安欸  | 俺欸  | 案欸  | 暗欸  | 岸欸  | 阿内   | 庵欸  | 氨欸  | 氨欸  | 铵欸  | 铵欸  | 黯欸  | 谙欸  | 庵欸  | 
anen | 安恩   | 按嗯  | 安嗯  | 俺嗯  | 案嗯  | 暗嗯  | 岸嗯  | 安恩   | 庵嗯  | 胺嗯  | 氨嗯  | 鞍嗯  | 铵嗯  | 黯嗯  | 谙嗯  | 庵嗯  | 
aneng | 啊能   | 按鞥  | 安鞥  | 俺鞥  | 案鞥  | 暗鞥  | 岸鞥  | 啊能   | 胺鞥  | 胺鞥  | 氨鞥  | 鞍鞥  | 铵鞥  | 黯鞥  | 桉鞥  | 胺鞥  | 
aner | 安儿   | 俺儿   | 按二  | 安二  | 俺二  | 案二  | 暗二  | 安儿   | 岸二  | 庵二  | 胺二  | 鞍二  | 铵二  | 铵二  | 黯二  | 岸二  | 
anfa | 案发   | 按法   | 安发   | 按发  | 安发  | 俺发  | 案发  | 案发   | 岸发  | 岸发  | 庵发  | 胺发  | 氨发  | 铵发  | 黯发  | 暗发  | 
anfan | 案犯   | 按饭  | 安饭  | 俺饭  | 案饭  | 暗饭  | 岸饭  | 案犯   | 胺饭  | 胺饭  | 氨饭  | 鞍饭  | 黯饭  | 谙饭  | 谙饭  | 庵饭  | 
anfang | 安防   | 安放   | 暗访   | 暗房   | 案防   | 按放  | 安防   | 安防   | 案放  | 俺放  | 岸放  | 暗放  | 岸放  | 氨放  | 胺放  | 安放  | 
anfei | 安菲   | 安妃   | 安徽   | 按非  | 安非  | 俺非  | 安菲   | 安菲   | 岸非  | 暗非  | 岸非  | 氨非  | 鞍非  | 氨非  | 黯非  | 案非  | 
anfen | 安分   | 氨酚   | 按份   | 按分  | 安分  | 俺分  | 案分  | 安分   | 岸分  | 庵分  | 庵分  | 氨分  | 氨分  | 鞍分  | 铵分  | 暗分  | 
anfeng | 安丰   | 暗讽   | 安峰   | 按风  | 安风  | 俺风  | 案风  | 安丰   | 暗风  | 岸风  | 庵风  | 氨风  | 氨风  | 铵风  | 黯风  | 暗风  | 
anfiao | 按覅   | 按覅  | 安覅  | 俺覅  | 案覅  | 暗覅  | 岸覅  | 按覅   | 庵覅  | 氨覅  | 氨覅  | 鞍覅  | 铵覅  | 黯覅  | 谙覅  | 庵覅  | 
anfo | 按佛   | 按佛  | 安佛  | 俺佛  | 案佛  | 暗佛  | 岸佛  | 按佛   | 胺佛  | 胺佛  | 氨佛  | 鞍佛  | 黯佛  | 谙佛  | 谙佛  | 胺佛  | 
anfou | 安否   | 按否  | 安否  | 俺否  | 案否  | 暗否  | 岸否  | 安否   | 庵否  | 胺否  | 氨否  | 铵否  | 铵否  | 黯否  | 谙否  | 胺否  | 
anfu | 安抚   | 安福   | 安富   | 暗敷   | 安服   | 按夫  | 安抚   | 安抚   | 案夫  | 暗夫  | 案夫  | 暗夫  | 胺夫  | 庵夫  | 胺夫  | 案夫  | 
anga | 昂啊   | 昂啊  | 盎啊  | 肮啊  | 卬啊  | 岇啊  | 枊啊  | 昂啊   | 醠啊  | 醃啊  | 骯啊  | 骯啊  | 按噶  | 安噶  | 俺噶  | 昻啊  | 
angai | 暗改   | 昂哎  | 盎哎  | 肮哎  | 卬哎  | 岇哎  | 枊哎  | 暗改   | 醠哎  | 昻哎  | 骯哎  | 骯哎  | 按该  | 安该  | 俺该  | 醠哎  | 
angan | 安敢   | 昂按  | 盎按  | 肮按  | 卬按  | 岇按  | 枊按  | 安敢   | 醠按  | 昻按  | 醃按  | 按干  | 按干  | 安干  | 俺干  | 醠按  | 
angang | 鞍钢   | 昂昂   | 安钢   | 暗杠   | 昂昂  | 盎昂  | 鞍钢   | 鞍钢   | 肮昂  | 枊昂  | 岇昂  | 昻昂  | 醃昂  | 昻昂  | 按杠  | 岇昂  | 
angao | 安高   | 昂奥  | 盎奥  | 肮奥  | 卬奥  | 岇奥  | 枊奥  | 安高   | 醠奥  | 昻奥  | 醃奥  | 骯奥  | 按高  | 安高  | 俺高  | 醠奥  | 
ange | 按个   | 安格   | 安哥   | 安个   | 俺哥   | 暗格   | 按个   | 按个   | 昂二  | 盎二  | 肮二  | 盎二  | 肮二  | 卬二  | 岇二  | 安歌   | 
angei | 按给   | 昂欸  | 盎欸  | 肮欸  | 卬欸  | 岇欸  | 枊欸  | 按给   | 昻欸  | 昻欸  | 醃欸  | 按给  | 安给  | 安给  | 案给  | 醠欸  | 
angen | 铵根   | 昂嗯  | 盎嗯  | 肮嗯  | 卬嗯  | 岇嗯  | 枊嗯  | 铵根   | 醠嗯  | 昻嗯  | 醃嗯  | 骯嗯  | 按跟  | 安跟  | 俺跟  | 醠嗯  | 
angeng | 按更   | 昂鞥  | 盎鞥  | 肮鞥  | 卬鞥  | 岇鞥  | 枊鞥  | 按更   | 醠鞥  | 昻鞥  | 醃鞥  | 按更  | 按更  | 安更  | 俺更  | 昻鞥  | 
angong | 安宫   | 安工   | 按共  | 安共  | 俺共  | 案共  | 暗共  | 安宫   | 岸共  | 胺共  | 胺共  | 氨共  | 铵共  | 铵共  | 谙共  | 岸共  | 
angou | 暗沟   | 昂偶  | 盎偶  | 肮偶  | 卬偶  | 岇偶  | 枊偶  | 暗沟   | 昻偶  | 昻偶  | 醃偶  | 骯偶  | 安狗  | 安狗  | 俺狗  | 昻偶  | 
angu | 安谷   | 安固   | 俺姑   | angular   | 按古  | 安古  | 俺古  | 案古  | 暗古  | 岸古  | 庵古  | 胺古  | 氨古  | 鞍古  | 铵古  | 黯古  | 
angua | 按挂   | 安谷啊  | 安固啊  | 俺姑啊  | 按挂  | 安挂  | 俺挂  | 案挂  | 暗挂  | 岸挂  | 庵挂  | 胺挂  | 氨挂  | 鞍挂  | 铵挂  | 黯挂  | 
anguai | 按怪   | 安谷哎  | 安固哎  | 俺姑哎  | 按怪  | 安怪  | 俺怪  | 案怪  | 暗怪  | 岸怪  | 庵怪  | 胺怪  | 氨怪  | 鞍怪  | 铵怪  | 黯怪  | 
anguan | 安管   | 暗管   | 案管   | 岸罐   | 安谷按  | 安固按  | 俺姑按  | 按管  | 安管  | 俺管  | 案管  | 暗管  | 岸管  | 庵管  | 胺管  | 氨管  | 
anguang | 暗光   | 安广   | 安谷昂  | 安固昂  | 俺姑昂  | 按光  | 安光  | 俺光  | 案光  | 暗光  | 岸光  | 庵光  | 胺光  | 氨光  | 鞍光  | 铵光  | 
angui | 安规   | anguish   | 按贵  | 安贵  | 俺贵  | 案贵  | 暗贵  | 岸贵  | 庵贵  | 胺贵  | 氨贵  | 鞍贵  | 铵贵  | 黯贵  | 谙贵  | 桉贵  | 
angun | 按滚   | 按滚  | 安滚  | 俺滚  | 案滚  | 暗滚  | 岸滚  | 庵滚  | 胺滚  | 氨滚  | 鞍滚  | 铵滚  | 黯滚  | 谙滚  | 桉滚  | 唵滚  | 
anguo | 安国   | 按过   | 安谷哦  | 安固哦  | 俺姑哦  | 按过  | 安过  | 俺过  | 案过  | 暗过  | 岸过  | 庵过  | 胺过  | 氨过  | 鞍过  | 铵过  | 
anha | anharmonic   | 案发   | 按哈  | 安哈  | 俺哈  | 案哈  | 暗哈  | 岸哈  | 庵哈  | 胺哈  | 氨哈  | 鞍哈  | 铵哈  | 黯哈  | 谙哈  | 桉哈  | 
anhai | 安海   | 暗害   | 按还  | 安还  | 俺还  | 案还  | 暗还  | 岸还  | 庵还  | 胺还  | 氨还  | 鞍还  | 铵还  | 黯还  | 谙还  | 桉还  | 
anhan | 暗含   | 暗涵   | 按含  | 安含  | 俺含  | 案含  | 暗含  | 岸含  | 庵含  | 胺含  | 氨含  | 鞍含  | 铵含  | 黯含  | 谙含  | 桉含  | 
anhang | 按行   | 安防   | 按行  | 安行  | 俺行  | 案行  | 暗行  | 岸行  | 庵行  | 胺行  | 氨行  | 鞍行  | 铵行  | 黯行  | 谙行  | 桉行  | 
anhao | 安好   | 暗号   | 案号   | 按好   | 按好  | 安好  | 俺好  | 案好  | 暗好  | 岸好  | 庵好  | 胺好  | 氨好  | 鞍好  | 铵好  | 黯好  | 
anhe | 安和   | 暗合   | 暗盒   | 暗河   | 安河   | Anheuser   | 按和  | 安和  | 俺和  | 案和  | 暗和  | 岸和  | 庵和  | 胺和  | 氨和  | 鞍和  | 
anhei | 暗黑   | 黯黑   | 按黑  | 安黑  | 俺黑  | 案黑  | 暗黑  | 岸黑  | 庵黑  | 胺黑  | 氨黑  | 鞍黑  | 铵黑  | 黯黑  | 谙黑  | 桉黑  | 
anhen | 暗恨   | 按很  | 安很  | 俺很  | 案很  | 暗很  | 岸很  | 庵很  | 胺很  | 氨很  | 鞍很  | 铵很  | 黯很  | 谙很  | 桉很  | 唵很  | 
anheng | 安恒   | 按哼  | 安哼  | 俺哼  | 案哼  | 暗哼  | 岸哼  | 庵哼  | 胺哼  | 氨哼  | 鞍哼  | 铵哼  | 黯哼  | 谙哼  | 桉哼  | 唵哼  | 
anhm | 俺还没   | 安徽吗  | 暗黑吗  | 安好吗  | 暗号吗  | 安华吗  | 安和吗  | 暗含吗  | 暗红吗  | 安化吗  | 暗黄吗  | 安海吗  | 案后吗  | 暗害吗  | 案号吗  | 暗合吗  | 
anhng | 按行   | 安徽那个   | 安徽那个  | 暗黑那个  | 安好那个  | 暗号那个  | 安华那个  | 安和那个  | 暗含那个  | 暗红那个  | 安化那个  | 暗黄那个  | 安海那个  | 案后那个  | 暗害那个  | 案号那个  | 
anhong | 暗红   | 安红   | 安宏   | 按宏   | 按红  | 安红  | 俺红  | 案红  | 暗红  | 岸红  | 庵红  | 胺红  | 氨红  | 鞍红  | 铵红  | 黯红  | 
anhou | 案后   | 庵后   | 按后  | 安后  | 俺后  | 案后  | 暗后  | 岸后  | 庵后  | 胺后  | 氨后  | 鞍后  | 铵后  | 黯后  | 谙后  | 桉后  | 
anhu | 安琥   | 按户   | 按胡  | 安胡  | 俺胡  | 案胡  | 暗胡  | 岸胡  | 庵胡  | 胺胡  | 氨胡  | 鞍胡  | 铵胡  | 黯胡  | 谙胡  | 桉胡  | 
anhua | 安华   | 安化   | 暗花   | 氨化   | 暗话   | 胺化   | 安琥啊  | 按户啊  | 按话  | 安话  | 俺话  | 案话  | 暗话  | 岸话  | 庵话  | 胺话  | 
anhuai | 按坏   | 安琥哎  | 按户哎  | 按坏  | 安坏  | 俺坏  | 案坏  | 暗坏  | 岸坏  | 庵坏  | 胺坏  | 氨坏  | 鞍坏  | 铵坏  | 黯坏  | 谙坏  | 
anhuan | 安环   | 安琥按  | 按户按  | 按换  | 安换  | 俺换  | 案换  | 暗换  | 岸换  | 庵换  | 胺换  | 氨换  | 鞍换  | 铵换  | 黯换  | 谙换  | 
anhuang | 暗黄   | 安琥昂  | 按户昂  | 按黄  | 安黄  | 俺黄  | 案黄  | 暗黄  | 岸黄  | 庵黄  | 胺黄  | 氨黄  | 鞍黄  | 铵黄  | 黯黄  | 谙黄  | 
anhui | 安徽   | 安慧   | 安惠   | 暗灰   | 安辉   | 按会  | 安会  | 俺会  | 案会  | 暗会  | 岸会  | 庵会  | 胺会  | 氨会  | 鞍会  | 铵会  | 
anhun | 安魂   | 暗魂   | 按混  | 安混  | 俺混  | 案混  | 暗混  | 岸混  | 庵混  | 胺混  | 氨混  | 鞍混  | 铵混  | 黯混  | 谙混  | 桉混  | 
anhuo | 暗火   | 安琥哦  | 按户哦  | 按或  | 安或  | 俺或  | 案或  | 暗或  | 岸或  | 庵或  | 胺或  | 氨或  | 鞍或  | 铵或  | 黯或  | 谙或  | 
anji | 安吉   | 氨基   | 胺基   | 暗记   | 岸基   | 暗疾   | 按季   | 案几   | 按及  | 安及  | 俺及  | 案及  | 暗及  | 岸及  | 庵及  | 胺及  | 
anjia | 俺家   | 安家   | 安佳   | 安嘉   | 按价   | 安吉啊  | 氨基啊  | 胺基啊  | 暗记啊  | 岸基啊  | 暗疾啊  | 按季啊  | 案几啊  | 按加  | 安加  | 俺加  | 
anjian | 案件   | 按键   | 安检   | 安监   | 暗箭   | 按件   | 安健   | 鞍鞯   | 安建   | 安吉按  | 氨基按  | 胺基按  | 暗记按  | 岸基按  | 暗疾按  | 按季按  | 
anjiang | 暗降   | 安江   | 暗将   | 安酱   | 案件   | 安吉昂  | 氨基昂  | 胺基昂  | 暗记昂  | 岸基昂  | 暗疾昂  | 按季昂  | 案几昂  | 按将  | 安将  | 俺将  | 
anjiao | 暗礁   | 暗角   | 按脚   | 俺家哦  | 安家哦  | 安佳哦  | 安嘉哦  | 按价哦  | 安吉奥  | 氨基奥  | 胺基奥  | 暗记奥  | 岸基奥  | 暗疾奥  | 按季奥  | 案几奥  | 
anjie | 按揭   | 安杰   | 安捷   | 安洁   | 安姐   | 俺姐   | 氨解   | 安吉二  | 氨基二  | 胺基二  | 暗记二  | 岸基二  | 暗疾二  | 按季二  | 案几二  | 按姐  | 
anjin | 暗金   | 按斤   | 安进   | 按金   | 按紧   | 按金  | 安金  | 俺金  | 案金  | 暗金  | 岸金  | 庵金  | 胺金  | 氨金  | 鞍金  | 铵金  | 
anjing | 安静   | 安井   | 安靖   | 暗警   | 🤫   | 按经  | 安经  | 俺经  | 案经  | 暗经  | 岸经  | 庵经  | 胺经  | 氨经  | 鞍经  | 铵经  | 
anjiong | 按囧   | 按囧  | 安囧  | 俺囧  | 案囧  | 暗囧  | 岸囧  | 庵囧  | 胺囧  | 氨囧  | 鞍囧  | 铵囧  | 黯囧  | 谙囧  | 桉囧  | 唵囧  | 
anjiu | 俺就   | 安久   | 安九   | 俺舅   | 按就  | 安就  | 俺就  | 案就  | 暗就  | 岸就  | 庵就  | 胺就  | 氨就  | 鞍就  | 铵就  | 黯就  | 
anju | 安居   | 按据  | 安据  | 俺据  | 案据  | 暗据  | 岸据  | 庵据  | 胺据  | 氨据  | 鞍据  | 铵据  | 黯据  | 谙据  | 桉据  | 唵据  | 
anjuan | 案卷   | 安居按  | 按卷  | 安卷  | 俺卷  | 案卷  | 暗卷  | 岸卷  | 庵卷  | 胺卷  | 氨卷  | 鞍卷  | 铵卷  | 黯卷  | 谙卷  | 桉卷  | 
anjue | 暗谲   | 安居二  | 按绝  | 安绝  | 俺绝  | 案绝  | 暗绝  | 岸绝  | 庵绝  | 胺绝  | 氨绝  | 鞍绝  | 铵绝  | 黯绝  | 谙绝  | 桉绝  | 
anjun | 安军   | 安筠   | 按军  | 安军  | 俺军  | 案军  | 暗军  | 岸军  | 庵军  | 胺军  | 氨军  | 鞍军  | 铵军  | 黯军  | 谙军  | 桉军  | 
anka | 安卡   | 暗卡   | Ankara   | 按卡  | 安卡  | 俺卡  | 案卡  | 暗卡  | 岸卡  | 庵卡  | 胺卡  | 氨卡  | 鞍卡  | 铵卡  | 黯卡  | 谙卡  | 
ankai | 安凯   | 暗凯   | 按开  | 安开  | 俺开  | 案开  | 暗开  | 岸开  | 庵开  | 胺开  | 氨开  | 鞍开  | 铵开  | 黯开  | 谙开  | 桉开  | 
ankan | 俺看   | 按看  | 安看  | 俺看  | 案看  | 暗看  | 岸看  | 庵看  | 胺看  | 氨看  | 鞍看  | 铵看  | 黯看  | 谙看  | 桉看  | 唵看  | 
ankang | 安康   | 暗抗   | 按康  | 安康  | 俺康  | 案康  | 暗康  | 岸康  | 庵康  | 胺康  | 氨康  | 鞍康  | 铵康  | 黯康  | 谙康  | 桉康  | 
ankao | 安靠   | 安卡哦  | 暗卡哦  | 按靠  | 安靠  | 俺靠  | 案靠  | 暗靠  | 岸靠  | 庵靠  | 胺靠  | 氨靠  | 鞍靠  | 铵靠  | 黯靠  | 谙靠  | 
anke | 安可   | 安科   | Anker   | 按可  | 安可  | 俺可  | 案可  | 暗可  | 岸可  | 庵可  | 胺可  | 氨可  | 鞍可  | 铵可  | 黯可  | 谙可  | 
ankei | 按剋   | 按剋  | 安剋  | 俺剋  | 案剋  | 暗剋  | 岸剋  | 庵剋  | 胺剋  | 氨剋  | 鞍剋  | 铵剋  | 黯剋  | 谙剋  | 桉剋  | 唵剋  | 
anken | 安肯   | 按肯  | 安肯  | 俺肯  | 案肯  | 暗肯  | 岸肯  | 庵肯  | 胺肯  | 氨肯  | 鞍肯  | 铵肯  | 黯肯  | 谙肯  | 桉肯  | 唵肯  | 
ankeng | 安坑   | 按坑  | 安坑  | 俺坑  | 案坑  | 暗坑  | 岸坑  | 庵坑  | 胺坑  | 氨坑  | 鞍坑  | 铵坑  | 黯坑  | 谙坑  | 桉坑  | 唵坑  | 
ankong | 安控   | 按空  | 安空  | 俺空  | 案空  | 暗空  | 岸空  | 庵空  | 胺空  | 氨空  | 鞍空  | 铵空  | 黯空  | 谙空  | 桉空  | 唵空  | 
ankou | 暗扣   | 按扣   | 安口   | 按口  | 安口  | 俺口  | 案口  | 暗口  | 岸口  | 庵口  | 胺口  | 氨口  | 鞍口  | 铵口  | 黯口  | 谙口  | 
anku | 安库   | 按库  | 安库  | 俺库  | 案库  | 暗库  | 岸库  | 庵库  | 胺库  | 氨库  | 鞍库  | 铵库  | 黯库  | 谙库  | 桉库  | 唵库  | 
ankua | 按跨   | 按跨  | 安跨  | 俺跨  | 案跨  | 暗跨  | 岸跨  | 庵跨  | 胺跨  | 氨跨  | 鞍跨  | 铵跨  | 黯跨  | 谙跨  | 桉跨  | 唵跨  | 
ankuai | 按快   | 按快  | 安快  | 俺快  | 案快  | 暗快  | 岸快  | 庵快  | 胺快  | 氨快  | 鞍快  | 铵快  | 黯快  | 谙快  | 桉快  | 唵快  | 
ankuan | 案款   | 按款  | 安款  | 俺款  | 案款  | 暗款  | 岸款  | 庵款  | 胺款  | 氨款  | 鞍款  | 铵款  | 黯款  | 谙款  | 桉款  | 唵款  | 
ankuang | 按狂   | 按狂  | 安狂  | 俺狂  | 案狂  | 暗狂  | 岸狂  | 庵狂  | 胺狂  | 氨狂  | 鞍狂  | 铵狂  | 黯狂  | 谙狂  | 桉狂  | 唵狂  | 
ankui | 暗亏   | 按亏  | 安亏  | 俺亏  | 案亏  | 暗亏  | 岸亏  | 庵亏  | 胺亏  | 氨亏  | 鞍亏  | 铵亏  | 黯亏  | 谙亏  | 桉亏  | 唵亏  | 
ankun | 安坤   | 按困  | 安困  | 俺困  | 案困  | 暗困  | 岸困  | 庵困  | 胺困  | 氨困  | 鞍困  | 铵困  | 黯困  | 谙困  | 桉困  | 唵困  | 
ankuo | 岸阔   | 按阔  | 安阔  | 俺阔  | 案阔  | 暗阔  | 岸阔  | 庵阔  | 胺阔  | 氨阔  | 鞍阔  | 铵阔  | 黯阔  | 谙阔  | 桉阔  | 唵阔  | 
anla | 安啦   | 安拉   | 按啦  | 安啦  | 俺啦  | 案啦  | 暗啦  | 岸啦  | 庵啦  | 胺啦  | 氨啦  | 鞍啦  | 铵啦  | 黯啦  | 谙啦  | 桉啦  | 
anlai | 俺来   | 安来   | 按来  | 安来  | 俺来  | 案来  | 暗来  | 岸来  | 庵来  | 胺来  | 氨来  | 鞍来  | 铵来  | 黯来  | 谙来  | 桉来  | 
anlan | 安澜   | 暗蓝   | 安岚   | 按蓝  | 安蓝  | 俺蓝  | 案蓝  | 暗蓝  | 岸蓝  | 庵蓝  | 胺蓝  | 氨蓝  | 鞍蓝  | 铵蓝  |黯蓝  | 谙蓝  | 
anlang | 暗狼   | 按狼  | 安狼  | 俺狼  | 案狼  | 暗狼  | 岸狼  | 庵狼  | 胺狼  | 氨狼  | 鞍狼  | 铵狼  | 黯狼  | 谙狼  | 桉狼  | 唵狼  | 
anlao | 安老   | 按劳   | 安啦哦  | 安拉哦  | 按老  | 安老  | 俺老  | 案老  | 暗老  | 岸老  | 庵老  | 胺老  | 氨老  | 鞍老  | 铵老  | 黯老  | 
anle | 安乐   | 按了   | 安了   | 暗了   | 按了  | 安了  | 俺了  | 案了  | 暗了  | 岸了  | 庵了  | 胺了  | 氨了  | 鞍了  | 铵了  | 黯了  | 
anlei | 胺类   | 暗雷   | 安磊   | 安雷   | 按类  | 安类  | 俺类  | 案类  | 暗类  | 岸类  | 庵类  | 胺类  | 氨类  | 鞍类  | 铵类  | 黯类  | 
anlen | 按冷   | 按冷  | 安冷  | 俺冷  | 案冷  | 暗冷  | 岸冷  | 庵冷  | 胺冷  | 氨冷  | 鞍冷  | 铵冷  | 黯冷  | 谙冷  | 桉冷  | 唵冷  | 
anleng | 按冷   | 按冷  | 安冷  | 俺冷  | 案冷  | 暗冷  | 岸冷  | 庵冷  | 胺冷  | 氨冷  | 鞍冷  | 铵冷  | 黯冷  | 谙冷  | 桉冷  | 唵冷  | 
anli | 案例   | 安利   | 按理   | 暗里   | 安立   | 安里   | 安丽   | 按例   | 安莉   | 安理   | 按里  | 安里  | 俺里  | 案里  | 暗里  | 岸里  | 
anlia | 俺俩   | 案例啊  | 安利啊  | 按理啊  | 暗里啊  | 安立啊  | 安里啊  | 安丽啊  | 按例啊  | 安莉啊  | 安理啊  | 按俩  | 安俩  | 俺俩  | 案俩  | 暗俩  | 
anlian | 暗恋   | 安联   | 谙练   | 案例按  | 安利按  | 按理按  | 暗里按  | 安立按  | 安里按  | 安丽按  | 按例按  | 安莉按  | 安理按  | 按连  | 安连  | 俺连  | 
anliang | 按量   | 安良   | 暗梁   | 安粮   | 案例昂  | 安利昂  | 按理昂  | 暗里昂  | 安立昂  | 安里昂  | 安丽昂  | 按例昂  | 安莉昂  | 安理昂  | 按两  | 安两  | 
anliao | 按了   | 俺俩哦  | 案例奥  | 安利奥  | 按理奥  | 暗里奥  | 安立奥  | 安里奥  | 安丽奥  | 按例奥  | 安莉奥  | 安理奥  | 按了  | 安了  | 俺了  | 案了  | 
anlie | 案列   | 按列   | 暗猎   | 案例二  | 安利二  | 按理二  | 暗里二  | 安立二  | 安里二  | 安丽二  | 按例二  | 安莉二  | 安理二  | 按列  | 安列  | 俺列  | 
anlin | 安林   | 按林  | 安林  | 俺林  | 案林  | 暗林  | 岸林  | 庵林  | 胺林  | 氨林  | 鞍林  | 铵林  | 黯林  | 谙林  | 桉林  | 唵林  | 
anling | 按铃   | 暗灵   | 安岭   | 按零  | 安零  | 俺零  | 案零  | 暗零  | 岸零  | 庵零  | 胺零  | 氨零  | 鞍零  | 铵零  | 黯零  | 谙零  | 
anliu | 暗流   | 按六  | 安六  | 俺六  | 案六  | 暗六  | 岸六  | 庵六  | 胺六  | 氨六  | 鞍六  | 铵六  | 黯六  | 谙六  | 桉六  | 唵六  | 
anlo | 安咯   | 按咯  | 安咯  | 俺咯  | 案咯  | 暗咯  | 岸咯  | 庵咯  | 胺咯  | 氨咯  | 鞍咯  | 铵咯  | 黯咯  | 谙咯  | 桉咯  | 唵咯  | 
anlong | 安龙   | 暗龙   | 按龙  | 安龙  | 俺龙  | 案龙  | 暗龙  | 岸龙  | 庵龙  | 胺龙  | 氨龙  | 鞍龙  | 铵龙  | 黯龙  | 谙龙  | 桉龙  | 
anlou | 安喽   | 按楼  | 安楼  | 俺楼  | 案楼  | 暗楼  | 岸楼  | 庵楼  | 胺楼  | 氨楼  | 鞍楼  | 铵楼  | 黯楼  | 谙楼  | 桉楼  | 唵楼  | 
anlu | 安陆   | 安路   | 安麓   | 暗路   | 按路  | 安路  | 俺路  | 案路  | 暗路  | 岸路  | 庵路  | 胺路  | 氨路  | 鞍路  | 铵路  | 黯路  | 
anluan | 按乱   | 安陆按  | 安路按  | 安麓按  | 暗路按  | 按乱  | 安乱  | 俺乱  | 案乱  | 暗乱  | 岸乱  | 庵乱  | 胺乱  | 氨乱  | 鞍乱  | 铵乱  | 
anlun | 氨纶   | 按论  | 安论  | 俺论  | 案论  | 暗论  | 岸论  | 庵论  | 胺论  | 氨论  | 鞍论  | 铵论  | 黯论  | 谙论  | 桉论  | 唵论  | 
anluo | 安落   | 安陆哦  | 安路哦  | 安麓哦  | 暗路哦  | 按罗  | 安罗  | 俺罗  | 案罗  | 暗罗  | 岸罗  | 庵罗  | 胺罗  | 氨罗  | 鞍罗  | 铵罗  | 
anlv | 暗绿   | 氨氯   | 按率  | 安率  | 俺率  | 案率  | 暗率  | 岸率  | 庵率  | 胺率  | 氨率  | 鞍率  | 铵率  | 黯率  | 谙率  | 桉率  | 
anlve | 按略   | 暗绿二  | 氨氯二  | 按略  | 安略  | 俺略  | 案略  | 暗略  | 岸略  | 庵略  | 胺略  | 氨略  | 鞍略  | 铵略  | 黯略  | 谙略  | 
anm | 按摩   | 俺们   | 俺妈   | 安眠   | 安民   | 鞍马   | 暗牧   | 安谧   | 暗门   | 安曼   | 安美   | 案名   | 俺没   | 按脉   | 暗骂   | 安明   | 
anma | 俺妈   | 鞍马   | 暗骂   | 暗码   | 安妈   | 按吗  | 安吗  | 俺吗  | 案吗  | 暗吗  | 岸吗  | 庵吗  | 胺吗  | 氨吗  | 鞍吗  | 铵吗  | 
anmai | 按脉   | 暗埋   | 安迈   | 按买  | 安买  | 俺买  | 案买  | 暗买  | 岸买  | 庵买  | 胺买  | 氨买  | 鞍买  | 铵买  | 黯买  | 谙买  | 
anman | 安曼   | 安缦   | 安满   | 按满  | 安满  | 俺满  | 案满  | 暗满  | 岸满  | 庵满  | 胺满  | 氨满  | 鞍满  | 铵满  | 黯满  | 谙满  | 
anmang | 按忙   | 按忙  | 安忙  | 俺忙  | 案忙  | 暗忙  | 岸忙  | 庵忙  | 胺忙  | 氨忙  | 鞍忙  | 铵忙  | 黯忙  | 谙忙  | 桉忙  | 唵忙  | 
anmao | 暗矛   | 俺妈哦  | 鞍马哦  | 暗骂哦  | 暗码哦  | 安妈哦  | 按毛  | 安毛  | 俺毛  | 案毛  | 暗毛  | 岸毛  | 庵毛  | 胺毛  | 氨毛  | 鞍毛  | 
anme | 俺么   | 按么  | 安么  | 俺么  | 案么  | 暗么  | 岸么  | 庵么  | 胺么  | 氨么  | 鞍么  | 铵么  | 黯么  | 谙么  | 桉么  | 唵么  | 
anmei | 安美   | 俺没   | 俺妹   | 暗昧   | 按没  | 安没  | 俺没  | 案没  | 暗没  | 岸没  | 庵没  | 胺没  | 氨没  | 鞍没  | 铵没  | 黯没  | 
anmen | 俺们   | 暗门   | 安门   | 按们  | 安们  | 俺们  | 案们  | 暗们  | 岸们  | 庵们  | 胺们  | 氨们  | 鞍们  | 铵们  | 黯们  | 谙们  | 
anmeng | 安盟   | 安梦   | 俺们   | 按梦  | 安梦  | 俺梦  | 案梦  | 暗梦  | 岸梦  | 庵梦  | 胺梦  | 氨梦  | 鞍梦  | 铵梦  | 黯梦  | 谙梦  | 
anmi | 安谧   | 安米   | 按米   | 按米  | 安米  | 俺米  | 案米  | 暗米  | 岸米  | 庵米  | 胺米  | 氨米  | 鞍米  | 铵米  | 黯米  | 谙米  | 
anmian | 安眠   | 暗面   | 安谧按  | 安米按  | 按米按  | 按面  | 安面  | 俺面  | 案面  | 暗面  | 岸面  | 庵面  | 胺面  | 氨面  | 鞍面  | 铵面  | 
anmiao | 按秒   | 安谧奥  | 安米奥  | 按米奥  | 按秒  | 安秒  | 俺秒  | 案秒  | 暗秒  | 岸秒  | 庵秒  | 胺秒  | 氨秒  | 鞍秒  | 铵秒  | 黯秒  | 
anmie | 暗灭   | 黯灭   | 安谧二  | 安米二  | 按米二  | 按灭  | 安灭  | 俺灭  | 案灭  | 暗灭  | 岸灭  | 庵灭  | 胺灭  | 氨灭  | 鞍灭  | 铵灭  | 
anmin | 安民   | 安敏   | 按民  | 安民  | 俺民  | 案民  | 暗民  | 岸民  | 庵民  | 胺民  | 氨民  | 鞍民  | 铵民  | 黯民  | 谙民  | 桉民  | 
anming | 案名   | 安明   | 按名  | 安名  | 俺名  | 案名  | 暗名  | 岸名  | 庵名  | 胺名  | 氨名  | 鞍名  | 铵名  | 黯名  | 谙名  | 桉名  | 
anmiu | 按谬   | 按缪  | 安缪  | 俺缪  | 案缪  | 暗缪  | 岸缪  | 庵缪  | 胺缪  | 氨缪  | 鞍缪  | 铵缪  | 黯缪  | 谙缪  | 桉缪  | 唵缪  | 
anmo | 按摩   | 按莫  | 安莫  | 俺莫  | 💆‍   | 案莫  | 暗莫  | 岸莫  | 庵莫  | 胺莫  | 氨莫  | 鞍莫  | 铵莫  | 黯莫  | 谙莫  | 桉莫  | 
anmou | 安某   | 按某  | 安某  | 俺某  | 案某  | 暗某  | 岸某  | 庵某  | 胺某  | 氨某  | 鞍某  | 铵某  | 黯某  | 谙某  | 桉某  | 唵某  | 
anmu | 暗牧   | 桉木   | 按木  | 安木  | 俺木  | 案木  | 暗木  | 岸木  | 庵木  | 胺木  | 氨木  | 鞍木  | 铵木  | 黯木  | 谙木  | 桉木  | 
ann | 按钮   | 安娜   | 安妮   | 安宁   | 安南   | 安能   | 安纳   | 按你   | 按年   | 俺娘   | 安诺   | 按捺   | 安尼   | 按您   | 安内   | 安奈   | 
anna | 安娜   | 安纳   | 按捺   | Anna   | 按那  | 安那  | 俺那  | 案那  | 暗那  | 岸那  | 庵那  | 胺那  | 氨那  | 鞍那  | 铵那  | 黯那  | 
annai | 安奈   | 俺奶   | 按捺   | 按奶  | 安奶  | 俺奶  | 案奶  | 暗奶  | 岸奶  | 庵奶  | 胺奶  | 氨奶  | 鞍奶  | 铵奶  | 黯奶  | 谙奶  | 
annan | 安南   | 安楠   | 按男  | 安男  | 俺男  | 案男  | 暗男  | 岸男  | 庵男  | 胺男  | 氨男  | 鞍男  | 铵男  | 黯男  | 谙男  | 桉男  | 
annang | 按囊   | 按囊  | 安囊  | 俺囊  | 案囊  | 暗囊  | 岸囊  | 庵囊  | 胺囊  | 氨囊  | 鞍囊  | 铵囊  | 黯囊  | 谙囊  | 桉囊  | 唵囊  | 
annao | 暗恼   | 安娜哦  | 安纳哦  | 按捺哦  | 按闹  | 安闹  | 俺闹  | 案闹  | 暗闹  | 岸闹  | 庵闹  | 胺闹  | 氨闹  | 鞍闹  | 铵闹  | 黯闹  | 
anne | 俺呢   | Anne   | 按呢  | 安呢  | 俺呢  | 案呢  | 暗呢  | 岸呢  | 庵呢  | 胺呢  | 氨呢  | 鞍呢  | 铵呢  | 黯呢  | 谙呢  | 桉呢  | 
annei | 安内   | 案内   | 按内  | 安内  | 俺内  | 案内  | 暗内  | 岸内  | 庵内  | 胺内  | 氨内  | 鞍内  | 铵内  | 黯内  | 谙内  | 桉内  | 
