aa | 嗷嗷   | 爱爱   | 哎哎   | 暗暗   | 昂昂   | 安安   | 熬熬   | 矮矮   | 哀哀   | 凹凹   | 挨挨   | 按按   | 傲岸   | 唉唉   | 蔼蔼   | 艾艾   | 
aai | 爱爱   | 哎哎   | 按爱   | 安爱   | 唉唉   | 挨挨   | 哀哀   | 蔼蔼   | 矮矮   | 皑皑   | 艾艾   | 錒爱   | 啊爱   | 錒爱  | 啊爱  | 按爱  | 
aan | 啊啊女   | 安安   | 暗暗   | 按按   | 傲岸   | AAN   | 錒按  | 啊按  | 啊按  | AAN   | 按按  | 爱按  | 爱按  | 哎按  | 哎按  | 安安  | 
aang | 昂昂   | 安昂   | 安安过   | 安安工   | 錒昂  | 錒昂  | 啊昂  | 啊昂  | 按昂  | 按昂  | 爱昂  | 爱昂  | 哎昂  | 哎昂  | 安昂  | 阿昂  | 
aao | 阿敖   | 嗷嗷   | 熬熬   | 艾奥   | 袄袄   | 凹凹   | 啊啊哦  | 錒奥  | 錒奥  | 啊啊哦  | 啊啊哦  | 按奥  | 按奥  | 爱奥  | 爱奥  | 哎奥  | 
aba | 阿爸   | 爱不爱   | 阿坝   | 按不按   | 阿巴   | 阿八   | ABAQUS   | 熬吧   | 俺爸   | 爱吧   | 奥巴   | 安霸   | 爱拔   | 暗坝   | 錒吧  | 錒吧  | 
abai | 阿白   | 鳌拜   | 爱白   | 安白   | 錒白  | 錒白  | 啊白  | 啊白  | 按白  | 按白  | 爱白  | 哎白  | 哎白  | 安白  | 阿白  | 奥白  | 
aban | A版   | 爱不爱你   | A班   | 阿班   | 凹版   | 案板   | 俺班   | 安办   | 艾粄   | 按板   | 奥班   | 呆板   | 錒班  | abandon   | 錒班  | 啊班  | 
abang | 阿邦   | 安邦   | 奥邦   | 爱帮   | 爱邦   | 錒bang  | 啊bang  | 按bang  | 爱bang  | 哎bang  | 安bang  | 阿bang  | 奥bang  | 唉bang  | 昂bang  | 熬bang  | 
abao | 阿宝   | 阿包   | 阿豹   | 阿爆   | 阿保   | 阿鲍   | 安保   | 敖包   | 爱宝   | 安包   | 暗堡   | 澳宝   | 昂宝   | 安宝   | 奥宝   | 艾宝   | 
abei | 阿贝   | 阿北   | A杯   | 安倍   | 奥贝   | 爱贝   | 奥北   | 安北   | 澳贝   | 安贝   | 坳背   | 艾北   | 錒被  | 錒被  | 啊被  | 啊被  | 
aben | 阿笨   | 阿本   | 庵本   | 氨本   | 案本   | 暗本   | 俺本   | 安本   | 按本   | 奥本   | 岸本   | 錒本  | 錒本  | abend   | 啊本  | 啊本  | 
abeng | 氨泵   | 啊蹦   | 錒beng  | 啊beng  | 按beng  | 爱beng  | 哎beng  | 安beng  | 阿beng  | 奥beng  | 唉beng  | 昂beng  | 熬beng  | 俺beng  | 暗beng  | 案beng  | 
abi | 阿碧   | 阿比   | 阿鼻   | 澳币   | 奥比   | 艾比   | 鞍鼻   | 安比   | 爱彼   | 安币   | 奥币   | 埃比   | 安谧   | 錒比  | ability   | 錒比  | 
abian | 阿扁   | 岸边   | 癌变   | 挨边   | 氨苄   | 錒比按  | 阿边   | 奥比安   | 錒比按  | 錒变  | 錒变  | 啊变  | 啊变  | 按变  | 按变  | 爱彼岸  | 
abiang | 奥比昂   | 安碧昂   | 錒比昂  | 錒比昂  | 阿碧昂  | 阿碧昂  | 阿比昂  | 阿比昂  | 阿鼻昂  | 阿鼻昂  | 澳币昂  | 澳币昂  | 奥比昂  | 奥比昂  | 艾比昂  | 艾比昂  | 
abiao | 阿彪   | 阿标   | 岸标   | 安标   | 暗标   | 爱表   | 錒比奥  | 奥比奥   | 錒比奥  | 錒表  | 錒表  | 啊表  | 啊表  | 按表  | 按表  | 爱表  | 
abie | 啊别   | 錒比额  | 錒比额  | 錒逼额  | 錒逼额  | 啊别  | 按逼额  | 按逼额  | 爱逼额  | 爱逼额  | 哎逼额  | 哎逼额  | 安逼额  | 安逼额  | 阿逼额  | 阿逼额  | 
abin | 阿斌   | 阿彬   | 阿宾   | 安斌   | 錒bin  | 啊bin  | 按bin  | 爱bin  | 哎bin  | 安bin  | 阿bin  | 奥bin  | 唉bin  | 昂bin  | 熬bin  | 俺bin  | 
abing | 阿炳   | 阿冰   | 阿兵   | 癌病   | 暗病   | 艾饼   | 安兵   | 錒病  | 錒病  | 啊病  | 啊病  | 按病  | 按病  | 爱兵  | 爱兵  | 哎病  | 
abo | 阿伯   | 阿波   | 阿卜   | 阿博   | ABO   | 安博   | 奥博   | 爱博   | 艾博   | 安波   | 澳博   | 錒波  | 錒波  | 啊波  | 啊波  | 按波  | 
abu | 阿布   | 阿部   | 阿卜   | 俺不   | 奥布   | 爱步   | 暗部   | 安瓿   | 庵埠   | 爱不   | 安埠   | 安布   | 錒不  | Abu   | 錒不  | 啊不  | 
aca | academic   | 錒擦  | 啊擦  | 啊擦  | academic   | 按擦  | 按擦  | 爱擦  | 爱擦  | 哎擦  | 哎擦  | 安擦  | 安擦  | 阿擦  | 阿擦  | 奥擦  | 
acai | 阿菜   | 阿才   | 阿财   | 阿彩   | 昂才   | 爱财   | 安财   | 熬菜   | 安彩   | 爱才   | 澳彩   | 錒才  | 錒才  | 啊才  | 啊才  | 按才  | 
acan | 敖灿   | 安灿   | 阿餐   | 錒惨  | 錒惨  | 啊惨  | 啊惨  | 按惨  | 按惨  | 爱惨  | 爱惨  | 哎惨  | 哎惨  | 安惨  | 安惨  | 阿餐  | 
acang | 暗藏   | 暗舱   | 昂藏   | 奥藏   | 安仓   | 錒藏  | 錒藏  | 啊藏  | 啊藏  | 按藏  | 按藏  | 爱藏  | 爱藏  | 哎藏  | 哎藏  | 安藏  | 
acao | 凹槽   | 艾草   | 阿草   | 阿擦哦  | 啊擦哦  | 錒擦哦  | 錒草  | 錒草  | 啊草  | 啊草  | 按草  | 按草  | 爱草  | 爱草  | 哎草  | 哎草  | 
ace | ace   | 阿册   | 阿策   | 安策   | 錒测  | ace   | 啊测  | 啊测  | 按测  | 按测  | 爱测  | 爱测  | 哎测  | 哎测  | 安策  | 阿册  | 
acei | 爱吃   | 安驰   | 奥驰   | 啊测i  | 錒测i  | acei  | 阿册i  | 阿策i  | 安策i  | 錒ceiling  | 啊ceiling  | 按ceiling  | 爱ceiling  | 哎ceiling  | 安ceiling  | 阿ceiling  | 
acen | 安岑   | 啊测你   | 阿岑   | 錒cen  | 啊cen  | 按cen  | 爱cen  | 哎cen  | 安cen  | 阿cen  | 奥cen  | 唉cen  | 昂cen  | 熬cen  | 俺cen  | 暗cen  | 
aceng | 阿曾   | 錒层  | 錒层  | 啊层  | 啊层  | 按层  | 按层  | 爱层  | 爱层  | 哎层  | 哎层  | 安层  | 安层  | 阿曾  | 奥层  | 奥层  | 
acha | 阿茶   | 安插   | 暗查   | 錒差  | 錒差  | 啊差  | 啊差  | 按差  | 按差  | 爱差  | 爱差  | 哎差  | 哎差  | 安插  | 阿茶  | 奥差  | 
achai | 安拆   | 阿柴   | 錒拆  | 錒拆  | 啊拆  | 啊拆  | 按拆  | 按拆  | 爱拆  | 爱拆  | 哎拆  | 哎拆  | 安拆  | 阿柴  | 奥拆  | 奥拆  | 
achan | 鞍韂   | 安婵   | 阿产   | 錒产  | 錒产  | 啊产  | 啊产  | 按产  | 按产  | 爱产  | 爱产  | 哎产  | 哎产  | 安产  | 安产  | 阿产  | 
achang | 阿昌   | 阿长   | 案场   | 安昌   | 爱唱   | 暗场   | 安畅   | 艾畅   | 暗娼   | 錒长  | 錒长  | 啊长  | 啊长  | 按长  | 按长  | 爱唱  | 
achao | 阿超   | 挨吵   | 爱巢   | 安超   | 暗潮   | 澳超   | 啊差哦  | 錒差哦  | 錒超  | 錒超  | 啊超  | 啊超  | 按超  | 按超  | 爱巢  | 哎超  | 
ache | ache   | 爱车   | 安车   | 錒车  | 錒车  | 啊车  | 啊车  | 按车  | 按车  | 爱车  | 哎车  | 哎车  | 安车  | 阿车  | 阿车  | 奥车  | 
achen | 阿晨   | 阿辰   | 暗沉   | 艾辰   | 奥宸   | 安辰   | 錒陈  | 錒陈  | 啊陈  | 啊陈  | 按陈  | 按陈  | 爱陈  | 爱陈  | 哎陈  | 哎陈  | 
acheng | 阿城   | 阿成   | 阿诚   | 按成   | 爱称   | 熬成   | 奥城   | 安城   | 安诚   | 安成   | 傲城   | 爱城   | 澳橙   | 奥诚   | 爱成   | 案秤   | 
achi | 安驰   | 奥驰   | 爱吃   | achieve   | 錒吃  | 啊吃  | 啊吃  | achieve   | 按吃  | 按吃  | 爱吃  | 哎吃  | 哎吃  | 安驰  | 阿吃  | 阿吃  | 
achong | 爱宠   | 奥冲   | 爱充   | 安冲   | 安重   | 錒冲  | 錒冲  | 啊冲  | 啊冲  | 按冲  | 按冲  | 爱宠  | 哎冲  | 哎冲  | 安冲  | 阿冲  | 
achou | 阿丑   | 哀愁   | 挨抽   | 錒抽  | 錒抽  | 啊抽  | 啊抽  | 按抽  | 按抽  | 爱抽  | 爱抽  | 哎抽  | 哎抽  | 安抽  | 安抽  | 阿丑  | 
achu | 阿楚   | 暗处   | 爱出   | 熬出   | 按出   | 錒出  | 錒出  | 啊出  | 啊出  | 按出  | 爱出  | 哎出  | 哎出  | 安出  | 安出  | 阿楚  | 
achua | 阿川   | 啊出啊   | 錒出啊  | 錒歘  | 錒歘  | 啊出啊  | 按歘  | 按歘  | 爱歘  | 爱歘  | 哎歘  | 哎歘  | 安歘  | 安歘  | 阿歘  | 阿歘  | 
achuai | 阿处爱   | 啊出爱  | 啊出爱  | 錒出爱  | 錒出爱  | 錒雏爱  | 錒雏爱  | 啊雏爱  | 啊雏爱  | 按雏爱  | 按雏爱  | 爱雏爱  | 爱雏爱  | 哎雏爱  | 哎雏爱  | 安雏爱  | 
achuan | 阿川   | 安川   | 爱穿   | 啊出按  | 啊出按  | 錒出按  | 錒出按  | 錒穿  | 錒穿  | 啊穿  | 啊穿  | 按穿  | 按穿  | 爱穿  | 哎穿  | 哎穿  | 
achuang | 暗疮   | 奥创   | 爱创   | 安创   | 安床   | 安闯   | 啊出昂  | 啊出昂  | 錒出昂  | 錒出昂  | 錒床  | 錒床  | 啊床  | 啊床  | 按床  | 按床  | 
achui | 啊吹   | 錒吹  | 錒吹  | 啊吹  | 按吹  | 按吹  | 爱吹  | 爱吹  | 哎吹  | 哎吹  | 安吹  | 安吹  | 阿吹  | 阿吹  | 奥吹  | 奥吹  | 
achun | 阿春   | 阿纯   | 鹌鹑   | 爱春   | 錒春  | 錒春  | 啊春  | 啊春  | 按春  | 按春  | 爱春  | 哎春  | 哎春  | 安春  | 安春  | 阿春  | 
achuo | 按戳   | 啊出哦  | 錒出哦  | 錒戳  | 錒戳  | 啊戳  | 啊戳  | 按戳  | 爱戳  | 爱戳  | 哎戳  | 哎戳  | 安戳  | 安戳  | 阿戳  | 阿戳  | 
aci | 按此   | 挨次   | 按次   | 安次   | 艾糍   | 暗刺   | 哀辞   | ACI   | 錒次  | 啊次  | 啊次  | ACI   | 按此  | 爱次  | 爱次  | 哎次  | 
acong | 阿聪   | 錒从  | 錒从  | 啊从  | 啊从  | 按从  | 按从  | 爱从  | 爱从  | 哎从  | 哎从  | 安从  | 安从  | 阿聪  | 奥从  | 奥从  | 
acou | acoustic   | 錒凑  | 啊凑  | 啊凑  | acoustic   | 按凑  | 按凑  | 爱凑  | 爱凑  | 哎凑  | 哎凑  | 安凑  | 安凑  | 阿凑  | 阿凑  | 奥凑  | 
acu | acute   | 錒粗  | 啊粗  | 啊粗  | acute   | 按粗  | 按粗  | 爱粗  | 爱粗  | 哎粗  | 哎粗  | 安粗  | 安粗  | 阿粗  | 阿粗  | 奥粗  | 
acuan | 按攒   | 阿粗按  | 阿粗按  | 啊粗按  | 啊粗按  | 錒粗按  | 錒粗按  | 錒醋按  | 錒醋按  | 啊醋按  | 啊醋按  | 按醋按  | 按醋按  | 爱醋按  | 爱醋按  | 哎醋按  | 
acui | 阿崔   | 安翠   | 錒催  | 錒催  | 啊催  | acuity   | 啊催  | 按催  | 按催  | 爱催  | 爱催  | 哎催  | 哎催  | 安翠  | 阿崔  | 奥催  | 
acun | 俺村   | 奥村   | 安村   | 安存   | 錒存  | 錒存  | 啊存  | 啊存  | 按存  | 按存  | 爱存  | 爱存  | 哎存  | 哎存  | 安村  | 阿存  | 
acuo | 按错   | 安措   | 爱错   | 安厝   | 阿粗哦  | 啊粗哦  | 錒粗哦  | 錒错  | 錒错  | 啊错  | 啊错  | 按错  | 爱错  | 哎错  | 哎错  | 安措  | 
ada | 阿达   | Ada   | 阿大   | 爱大爱   | 挨打   | 安达   | 澳大   | 昂达   | 爱打   | 安大   | 艾达   | 奥达   | 爱达   | 安打   | 谙达   | 錒大  | 
adai | 阿呆   | 阿戴   | 爱戴   | 暗袋   | 奥戴   | 奥黛   | 澳代   | 叆叇   | 錒带  | 錒带  | 啊带  | 啊带  | 按带  | 按带  | 爱戴  | 哎带  | 
adan | 阿丹   | 阿蛋   | 阿旦   | 暗淡   | 氨氮   | 黯淡   | 艾丹   | 奥蛋   | 安单   | 錒但  | 錒但  | 啊但  | 啊但  | 按但  | 按但  | 爱但  | 
adang | 阿当   | 爱党   | 爱宕   | 錒当  | 錒当  | 啊当  | 啊当  | 按当  | 按当  | 爱党  | 哎当  | 哎当  | 安当  | 安当  | 阿当  | 奥当  | 
adao | 按到   | 熬到   | 挨到   | 爱到   | 暗道   | 哀悼   | 挨刀   | 按倒   | 安到   | 暗刀   | 阿道   | 錒大哦  | 錒到  | 錒到  | 啊到  | 啊到  | 
ade | ade   | 阿德   | 奥迪尔   | 阿黛尔   | 奥杜尔   | 爱迪尔   | 安道尔   | 艾迪尔   | 奥戴尔   | 奥代尔   | 埃德尔   | 安迪尔   | 爱的   | 奥德   | 俺的   | 按得   | 
adei | 俺得   | 阿得   | 錒得  | 錒得  | 啊得  | 啊得  | 按得  | 按得  | 爱得  | 爱得  | 哎得  | 哎得  | 安得  | 安得  | 阿得  | 奥得  | 
aden | 阿登   | 阿德南   | 爱的呢   | 爱的那   | 啊den  | 按den  | 爱den  | 哎den  | 安den  | 阿den  | 奥den  | 唉den  | 昂den  | 熬den  | 俺den  | 暗den  | 
adeng | 阿登   | 阿灯   | 阿邓   | A等   | 安灯   | 奥登   | 矮凳   | 艾登   | 錒等  | 錒等  | 啊等  | 啊等  | 按等  | 按等  | 爱等  | 爱等  | 
adi | adi   | 阿迪   | 阿弟   | 阿娣   | 奥迪   | 安迪   | 艾迪   | 暗帝   | 案底   | 爱迪   | 暗地   | 俺弟   | 傲滴   | 爱地   | 埃迪   | 爱滴   | 
adia | Adia   | 錒嗲  | 啊嗲  | 啊嗲  | Adia   | 按嗲  | 按嗲  | 爱嗲  | 爱嗲  | 哎嗲  | 哎嗲  | 安嗲  | 安嗲  | 阿嗲  | 阿嗲  | 奥嗲  | 
adian | A点   | 暗点   | 熬点   | 矮点   | 按点   | 凹点   | 暗殿   | 爱点   | 錒点  | 錒点  | 啊点  | 啊点  | 按点  | 爱点  | 哎点  | 哎点  | 
adiao | 阿刁   | 按掉   | 爱掉   | 暗调   | 安调   | 阿嗲哦  | 啊嗲哦  | 錒嗲哦  | 錒掉  | 錒掉  | 啊掉  | 啊掉  | 按掉  | 爱掉  | 哎掉  | 哎掉  | 
adie | 阿爹   | 俺爹   | 奥爹   | 錒爹  | 錒爹  | 啊爹  | adieu   | 啊爹  | 按爹  | 按爹  | 爱爹  | 爱爹  | 哎爹  | 哎爹  | 安爹  | 安爹  | 
adin | 安定   | 奥丁   | 阿丁   | 爱定   | 吖啶   | 奥迪男   | 阿迪娜   | adi你  | 阿迪你  | 阿迪你  | 阿弟你  | 阿弟你  | 阿娣你  | 阿娣你  | 奥迪你  | 奥迪你  | 
ading | 奥丁   | 爱定   | 安定   | 阿丁   | 吖啶   | 錒定  | 錒定  | 啊定  | 啊定  | 按定  | 按定  | 爱定  | 哎定  | 哎定  | 安定  | 阿丁  | 
adiu | 啊丢   | 錒丢  | 錒丢  | 啊丢  | 按丢  | 按丢  | 爱丢  | 爱丢  | 哎丢  | 哎丢  | 安丢  | 安丢  | 阿丢  | 阿丢  | 奥丢  | 奥丢  | 
adong | 阿东   | A栋   | 阿冬   | 安东   | 按动   | 挨冻   | 敖东   | 爱动   | 庵东   | 奥东   | 昂东   | 爱东   | 安冬   | 艾东   | 安栋   | 按栋   | 
adou | 阿斗   | 阿豆   | 爱豆   | 俺都   | 傲斗   | 暗斗   | 安兜   | 暗兜   | 岸兜   | 錒都  | 錒都  | 啊都  | 啊都  | 按都  | 按都  | 爱豆  | 
adu | 阿杜   | 阿渡   | 爱都   | 暗度   | 奥都   | 安度   | 爱度   | 爱读   | 安都   | 案牍   | 安堵   | 奥杜   | 錒度  | 錒度  | adult   | 啊度  | 
aduan | A段   | 阿短   | 凹断   | 拗断   | 啊度按  | 啊度按  | 錒度按  | 錒度按  | 錒赌按  | 錒赌按  | 啊赌按  | 啊赌按  | 按赌按  | 按赌按  | 爱赌按  | 爱赌按  | 
adui | 爱对   | 哎对   | 暗队   | 昂对   | 啊对   | 錒对  | 錒对  | 啊对  | 按对  | 按对  | 爱对  | 哎对  | 安对  | 安对  | 阿对  | 阿对  | 
adun | 安顿   | 暗盾   | 艾顿   | 奥顿   | 矮墩   | 安盾   | 按吨   | 錒顿  | 錒顿  | 啊顿  | 啊顿  | 按顿  | 按顿  | 爱顿  | 爱顿  | 哎顿  | 
aduo | 阿朵   | 阿多   | 阿哆   | 爱多   | 奥朵   | 安多   | 安朵   | 啊度哦  | aduo   | 錒度哦  | 錒duo  | 啊duo  | 按duo  | 爱duo  | 哎duo  | 安duo  | 
ae | 艾尔   | 阿尔   | 挨饿   | 媕娿   | 奥恩   | 俺儿   | 爱尔   | 奥尔   | 阿二   | 安儿   | 埃尔   | 爱儿   | 艾儿   | 啊恩   | 爱耳   | 錒额  | 
aei | 啊诶   | 錒诶  | 錒诶  | 啊诶  | 按诶  | 按诶  | 爱诶  | 爱诶  | 哎诶  | 哎诶  | 安诶  | 安诶  | 阿诶  | 阿诶  | 奥诶  | 奥诶  | 
aen | 啊恩   | 安儿宁   | 奥恩   | 錒嗯  | 錒嗯  | 啊恩  | 按嗯  | 按嗯  | 爱嗯  | 爱嗯  | 哎嗯  | 哎嗯  | 安嗯  | 安嗯  | 阿嗯  | 阿嗯  | 
aeng | 阿鞥   | 錒鞥  | 錒鞥  | 啊鞥  | 啊鞥  | 按鞥  | 按鞥  | 爱鞥  | 爱鞥  | 哎鞥  | 哎鞥  | 安鞥  | 安鞥  | 阿鞥  | 奥鞥  | 奥鞥  | 
aer | 阿尔   | 阿二   | 爱耳日   | 艾尔   | 俺儿   | 爱尔   | 奥尔   | 安儿   | 埃尔   | 爱儿   | 艾儿   | 爱耳   | 錒二  | 錒二  | aero   | 啊二  | 
afa | 阿发   | 案发   | 奥法   | 挨罚   | 爱发   | 安发   | 錒发  | 錒发  | 啊发  | 啊发  | 按发  | 按发  | 爱发  | 哎发  | 哎发  | 安发  | 
afan | 阿帆   | 案犯   | 奥帆   | 安返   | 熬饭   | 錒饭  | 錒饭  | 啊饭  | 啊饭  | 按饭  | 按饭  | 爱饭  | 爱饭  | 哎饭  | 哎饭  | 安返  | 
afang | 阿芳   | 阿方   | 阿房   | 安防   | 暗访   | 安放   | 爱芳   | 暗房   | 案防   | 爱房   | 錒放  | 錒放  | 啊放  | 啊放  | 按放  | 按放  | 
afei | 阿飞   | 阿菲   | 爱妃   | 安飞   | 奥菲   | 艾菲   | 奥飞   | 爱飞   | 艾飞   | 錒飞  | 錒飞  | 啊飞  | 啊飞  | 按飞  | 按飞  | 爱飞  | 
afen | 阿芬   | 阿粉   | 安分   | 氨酚   | 爱芬   | 昂奋   | 暗粉   | 艾芬   | 錒分  | 錒分  | 啊分  | 啊分  | 按分  | 按分  | 爱芬  | 哎分  | 
afeng | 阿峰   | 阿凤   | 阿枫   | 爱疯   | 安丰   | 傲风   | 暗讽   | 鳌峰   | 安峰   | 爱凤   | 奥峰   | 艾丰   | 安锋   | 安凤   | 錒风  | 錒风  | 
afiao | 阿覅   | 錒覅  | 錒覅  | 啊覅  | 啊覅  | 按覅  | 按覅  | 爱覅  | 爱覅  | 哎覅  | 哎覅  | 安覅  | 安覅  | 阿覅  | 奥覅  | 奥覅  | 
afo | afoot   | 錒佛  | 啊佛  | 啊佛  | afoot   | 按佛  | 按佛  | 爱佛  | 爱佛  | 哎佛  | 哎佛  | 安佛  | 安佛  | 阿佛  | 阿佛  | 奥佛  | 
afou | 爱否   | 安否   | 錒fou  | 啊fou  | 按fou  | 爱fou  | 哎fou  | 安fou  | 阿fou  | 奥fou  | 唉fou  | 昂fou  | 熬fou  | 俺fou  | 暗fou  | 案fou  | 
afu | 阿福   | 阿芙   | 阿附   | 阿父   | 安抚   | 爱抚   | 安福   | 暗敷   | 奥夫   | 安富   | 爱芙   | 澳服   | 奥父   | 錒付  | 錒付  | 啊付  | 
aga | again   | 錒噶  | 啊噶  | 啊噶  | again   | 按噶  | 按噶  | 爱噶  | 爱噶  | 哎噶  | 哎噶  | 安噶  | 安噶  | 阿噶  | 阿噶  | 奥噶  | 
agai | 阿盖   | 阿改   | 暗改   | 錒该  | 錒该  | again   | 啊该  | 啊该  | 按该  | 按该  | 爱该  | 爱该  | 哎该  | 哎该  | 安该  | 安该  | 
agan | 阿甘   | 暗杆   | 爱干   | 錒干  | 錒干  | 啊干  | 啊干  | 按干  | 按干  | 爱干  | 哎干  | 哎干  | 安干  | 安干  | 阿甘  | 奥干  | 
agang | 阿纲   | 阿刚   | 爱岗   | 鞍钢   | 安钢   | 暗杠   | 奥港   | 安刚   | 爱港   | 錒刚  | 錒刚  | 啊刚  | 啊刚  | 按刚  | 按刚  | 爱岗  | 
agao | 爱搞   | 安高   | 艾高   | 昂高   | 哀告   | 阿高   | 阿噶哦  | 啊噶哦  | 錒噶哦  | 錒高  | 錒高  | 啊高  | 啊高  | 按高  | 按高  | 爱搞  | 
age | 阿哥   | age   | 挨个儿   | 安格尔   | 阿格   | 矮个儿   | 阿戈尔   | 按个   | 挨个   | 俺哥   | 奥格   | 安格   | 安哥   | 艾格   | 昂个   | 爱格   | 
agei | 爱给   | 錒给  | 錒给  | 啊给  | 啊给  | 按给  | 按给  | 爱给  | 哎给  | 哎给  | 安给  | 安给  | 阿给  | 阿给  | 奥给  | 奥给  | 
agen | 阿根   | 爱跟   | 铵根   | 矮跟   | 俺跟   | 錒gen  | 啊gen  | 按gen  | agent   | 爱gen  | 哎gen  | 安gen  | 阿gen  | 奥gen  | 唉gen  | 昂gen  | 
ageng | 爱更   | 安耿   | 錒更  | 錒更  | 啊更  | 啊更  | 按更  | 按更  | 爱更  | 哎更  | 哎更  | 安更  | 安更  | 阿更  | 阿更  | 奥更  | 
agong | 阿公   | 安工   | 安宫   | 艾工   | 錒工  | 錒工  | 啊工  | 啊工  | 按工  | 按工  | 爱工  | 爱工  | 哎工  | 哎工  | 安工  | 阿公  | 
agou | 阿狗   | 爱狗   | 暗沟   | 爱购   | 錒够  | 錒够  | 啊够  | 啊够  | 按够  | 按够  | 爱狗  | 哎够  | 哎够  | 安够  | 安够  | 阿狗  | 
agu | A股   | 阿古   | 阿姑   | 阿顾   | agua   | 傲骨   | 俺姑   | 艾古   | 安固   | 奥古   | 安谷   | 癌股   | 錒古  | 錒古  | 啊古  | 啊古  | 
agua | agua   | 阿瓜   | 矮瓜   | 啊古啊  | 錒古啊  | 錒挂  | 錒挂  | 啊挂  | 啊挂  | 按挂  | 按挂  | 爱挂  | 爱挂  | 哎挂  | 哎挂  | 安挂  | 
aguai | 阿怪   | 啊古爱  | 啊古爱  | 錒古爱  | 錒古爱  | 錒鼓爱  | 錒鼓爱  | 啊鼓爱  | 啊鼓爱  | 按鼓爱  | 按鼓爱  | 爱鼓爱  | 爱鼓爱  | 哎鼓爱  | 哎鼓爱  | 安鼓爱  | 
aguan | 安管   | 暗管   | 案管   | 奥冠   | 安冠   | 啊古按  | 啊古按  | 錒古按  | 錒古按  | 錒管  | 錒管  | 啊管  | 啊管  | 按管  | 按管  | 爱管  | 
aguang | 阿光   | 安广   | 暗光   | 敖广   | 啊古昂  | 啊古昂  | 錒古昂  | 錒古昂  | 錒古昂  | 啊古昂  | 按古昂  | 按古昂  | 爱古昂  | 爱古昂  | 哎古昂  | 哎古昂  | 
agui | 阿贵   | 阿桂   | 阿鬼   | 阿龟   | 昂贵   | 安规   | 矮柜   | 澳规   | 錒贵  | 錒贵  | 啊贵  | 啊贵  | 按贵  | 按贵  | 爱贵  | 爱贵  | 
agun | 啊滚   | 錒滚  | 錒滚  | 啊滚  | 按滚  | 按滚  | 爱滚  | 爱滚  | 哎滚  | 哎滚  | 安滚  | 安滚  | 阿滚  | 阿滚  | 奥滚  | 奥滚  | 
aguo | 阿国   | 阿果   | 爱国   | 熬过   | 爱过   | 安国   | 挨过   | 按过   | 碍国   | 安果   | 啊古哦  | 錒古哦  | 錒过  | 錒过  | 啊过  | 啊过  | 
aha | 啊哈   | aha   | 阿哈   | 艾哈   | 安哈   | 奥哈   | 錒哈  | 錒哈  | 啊哈  | 按哈  | 按哈  | 爱哈  | 爱哈  | 哎哈  | 哎哈  | 安哈  | 
ahai | 阿海   | 安海   | 爱海   | 暗害   | 奥海   | 澳海   | 俺孩   | 錒还  | 錒还  | 啊还  | 啊还  | 按还  | 按还  | 爱海  | 哎还  | 哎还  | 
ahan | 阿汉   | 阿涵   | 暗含   | 傲寒   | 敖汉   | 暗涵   | 安翰   | 錒喊  | 錒喊  | 啊喊  | 啊喊  | 按喊  | 按喊  | 爱喊  | 爱喊  | 哎喊  | 
ahang | 阿航   | 安航   | 澳航   | 埃航   | 爱行   | 錒行  | 錒行  | 啊行  | 啊行  | 按行  | 按行  | 爱行  | 哎行  | 哎行  | 安航  | 阿航  | 
ahao | 阿豪   | 阿浩   | 阿好   | 爱好   | 安好   | 暗号   | 熬好   | 案号   | 哀嚎   | 艾蒿   | 按好   | 安浩   | 哀号   | 錒哈哦  | 錒好  | 錒好  | 
ahe | 阿和   | 阿河   | 暗花儿   | 阿赫   | 爱河   | 爱喝   | 暗盒   | 安和   | 奥和   | 爱和   | 暗河   | 暗合   | 安河   | 嗳呵   | 爱禾   | 錒和  | 
ahei | 阿黑   | 暗黑   | 哎嘿   | 黯黑   | 錒黑  | 錒黑  | 啊黑  | 啊黑  | 按黑  | 按黑  | 爱黑  | 爱黑  | 哎嘿  | 安黑  | 安黑  | 阿黑  | 
ahen | 爱恨   | 凹痕   | 俺很   | 懊恨   | 爱很   | 錒hen  | 啊hen  | 按hen  | 爱hen  | 哎hen  | 安hen  | 阿hen  | 奥hen  | 唉hen  | 昂hen  | 熬hen  | 
aheng | 阿恒   | 阿衡   | 安恒   | 艾恒   | 錒哼  | 錒哼  | 啊哼  | 啊哼  | 按哼  | 按哼  | 爱哼  | 爱哼  | 哎哼  | 哎哼  | 安恒  | 阿恒  | 
ahm | 爱很美   | 爱荷美   | Ahmad   | 爱好吗   | 啊哼吗  | 啊哼吗  | 錒哼吗  | 錒哼吗  | 啊黑吗  | 啊黑吗  | 錒黑吗  | 錒黑吗  | 錒和吗  | 錒和吗  | 錒好吗  | 錒好吗  | 
ahng | 行   | 航   | 杭   | 安徽那个   | 爱护你个  | 爱护你个  | 啊哼那个  | 啊哼那个  | 錒哼那个  | 錒哼那个  | 啊黑那个  | 啊黑那个  | 錒黑那个  | 錒黑那个  | 錒和那个  | 錒和那个  | 
ahong | 阿訇   | 阿红   | 阿鸿   | 暗红   | 安红   | 安宏   | 錒红  | 錒红  | 啊红  | 啊红  | 按红  | 按红  | 爱红  | 爱红  | 哎红  | 哎红  | 
ahou | 庵后   | 安厚   | 案后   | 安侯   | 錒后  | 錒后  | 啊后  | 啊后  | 按后  | 按后  | 爱后  | 爱后  | 哎后  | 哎后  | 安厚  | 阿后  | 
ahu | 阿虎   | 阿胡   | 爱护   | 安琥   | 傲虎   | 艾虎   | 挨户   | 凹弧   | 安虎   | 錒胡  | 錒胡  | 啊胡  | 啊胡  | 按胡  | 按胡  | 爱护  | 
ahua | 阿花   | 阿华   | 阿化   | 安华   | 爱华   | 安化   | 暗花   | 奥华   | 暗话   | 澳华   | 爱花   | 艾华   | 矮化   | 氨化   | 啊胡啊  | 錒胡啊  | 
ahuai | 阿怀   | 按坏   | 熬坏   | 爱坏   | 安怀   | 啊胡爱  | 啊胡爱  | 錒胡爱  | 錒胡爱  | 錒虎爱  | 錒虎爱  | 啊虎爱  | 啊虎爱  | 按坏  | 爱坏  | 哎虎爱  | 
ahuan | 阿欢   | 安环   | 爱换   | 啊胡按  | 啊胡按  | 錒胡按  | 錒胡按  | 錒换  | 錒换  | 啊换  | 啊换  | 按换  | 按换  | 爱换  | 哎换  | 哎换  | 
ahuang | 阿黄   | 暗黄   | 哀黄   | 啊胡昂  | 啊胡昂  | 錒胡昂  | 錒胡昂  | 錒黄  | 錒黄  | 啊黄  | 啊黄  | 按黄  | 按黄  | 爱黄  | 爱黄  | 哎黄  | 
ahui | 阿辉   | 阿慧   | 阿惠   | 安徽   | 懊悔   | 爱会   | 安慧   | 安辉   | 安惠   | 爱辉   | 昂辉   | 瑷珲   | 奥辉   | 澳汇   | 艾回   | 奥会   | 
ahun | 安魂   | 傲魂   | 瑷珲   | 爱护你   | 錒混  | 錒混  | 啊混  | 啊混  | 按混  | 按混  | 爱混  | 爱混  | 哎混  | 哎混  | 安魂  | 阿混  | 
ahuo | A货   | 阿火   | 暗火   | 爱火   | 奥火   | 艾火   | 啊胡哦  | 錒胡哦  | 錒或  | 錒或  | 啊或  | 啊或  | 按或  | 按或  | 爱火  | 哎或  | 
aji | A级   | 阿吉   | 阿基   | 阿鸡   | 阿季   | 阿纪   | 埃及   | 安吉   | 氨基   | 澳际   | 暗疾   | 暗记   | 傲基   | 爱机   | 安基   | 安记   | 
ajia | 阿加   | 阿佳   | 阿甲   | 阿家   | 俺家   | 爱家   | 安家   | 安佳   | 哀家   | 昂家   | 挨家   | 艾佳   | 爱佳   | 爱加   | 艾嘉   | 爱嘉   | 
ajian | 阿健   | 阿坚   | 阿建   | 案件   | 按键   | 安检   | 安监   | 挨肩   | 傲剑   | 按件   | 爱建   | 熬煎   | 安建   | 暗箭   | 鞍鞯   | 錒见  | 
ajiang | 阿江   | 安江   | 鳌江   | 爱酱   | 爱将   | 敖江   | 凹酱   | 錒讲  | 錒讲  | 啊讲  | 啊讲  | 按讲  | 按讲  | 爱将  | 哎讲  | 哎讲  | 
ajiao | 阿娇   | 阿胶   | 傲娇   | 暗礁   | 挨浇   | 按脚   | 矮脚   | 暗角   | 爱叫   | 熬胶   | 艾吉奥   | 爱娇   | 錒叫  | 錒叫  | 啊叫  | 啊叫  | 
ajie | 阿姐   | 阿杰   | 阿洁   | 按揭   | 俺姐   | 安捷   | 奥杰   | 娭毑   | 安杰   | 安洁   | 昂捷   | 爱姐   | 奥捷   | 爱杰   | 安节   | 錒接  | 
ajin | 阿金   | 阿进   | 阿锦   | 阿瑾   | 暗金   | 挨近   | 按斤   | 奥金   | 昂金   | 按金   | 安进   | 哀矜   | 錒进  | 錒进  | 啊进  | 啊进  | 
ajing | 阿静   | 阿晶   | 阿精   | 阿菁   | 安静   | 爱敬   | 安井   | 安靖   | 艾静   | 爱静   | 暗井   | 艾晶   | 黯晶   | 爱警   | 暗经   | 錒经  | 
ajiong | 阿囧   | 錒囧  | 錒囧  | 啊囧  | 啊囧  | 按囧  | 按囧  | 爱囧  | 爱囧  | 哎囧  | 哎囧  | 安囧  | 安囧  | 阿囧  | 奥囧  | 奥囧  | 
ajiu | 阿九   | 阿舅   | 阿酒   | 阿玖   | 艾灸   | 俺就   | 爱就   | 俺舅   | 安久   | 安九   | 錒就  | 錒就  | 啊就  | 啊就  | 按就  | 按就  | 
aju | 阿菊   | 安居   | 爱菊   | 鞍具   | 錒句  | 錒句  | 啊句  | 啊句  | 按句  | 按句  | 爱菊  | 哎句  | 哎句  | 安居  | 阿菊  | 奥句  | 
ajuan | 阿娟   | A卷   | 案卷   | 爱娟   | 啊句按  | 啊句按  | 錒句按  | 錒句按  | 錒卷  | 錒卷  | 啊卷  | 啊卷  | 按卷  | 按卷  | 爱娟  | 哎卷  | 
ajue | 艾爵   | 挨决   | 按绝   | 安珏   | 啊句额  | 啊句额  | 錒句额  | 錒句额  | 錒觉  | 錒觉  | 啊觉  | 啊觉  | 按觉  | 按觉  | 爱觉  | 爱觉  | 
ajun | 阿俊   | 阿君   | 阿军   | A君   | 爱军   | 安军   | 爱君   | 安俊   | 艾军   | 傲君   | 錒军  | 錒军  | 啊军  | 啊军  | 按军  | 按军  | 
aka | aka   | 阿卡   | A卡   | 爱卡   | 安卡   | 奥卡   | 氨咖   | 暗卡   | 艾卡   | 昂卡   | 錒卡  | aka   | 啊卡  | 啊卡  | 按卡  | 按卡  | 
akai | 阿凯   | 安凯   | 奥凯   | 昂开   | 暗凯   | 錒开  | 錒开  | 啊开  | AKAI   | 啊开  | 按开  | 按开  | 爱开  | 爱开  | 哎开  | 哎开  | 
akan | 爱看   | 俺看   | 奥坎   | 啊看   | 錒看  | 錒看  | 啊看  | 按看  | 按看  | 爱看  | 哎看  | 哎看  | 安看  | 安看  | 阿看  | 阿看  | 
akang | 阿康   | 安康   | 爱康   | 奥康   | 澳抗   | 艾康   | 暗抗   | 鮟鱇   | 錒抗  | 錒抗  | 啊抗  | 啊抗  | 按抗  | 按抗  | 爱康  | 哎抗  | 
akao | 安靠   | 啊卡哦  | 錒卡哦  | 錒靠  | 錒靠  | 啊靠  | 啊靠  | 按靠  | 按靠  | 爱靠  | 爱靠  | 哎靠  | 哎靠  | 安靠  | 阿靠  | 阿靠  | 
ake | ake   | 阿珂   | 阿克   | 阿科   | 阿轲   | 按扣儿   | 安可儿   | 艾克   | 安可   | 安科   | 澳客   | 艾科   | 奥克   | 爱客   | 昂科   | 奥科   | 
akei | 阿尅   | 錒尅  | 錒尅  | 啊尅  | 啊尅  | 按尅  | 按尅  | 爱尅  | 爱尅  | 哎尅  | 哎尅  | 安尅  | 安尅  | 阿尅  | 奥尅  | 奥尅  | 
aken | 阿肯   | 艾肯   | 奥肯   | 安肯   | 爱肯   | 錒肯  | 錒肯  | 啊肯  | 啊肯  | 按肯  | 按肯  | 爱肯  | 哎肯  | 哎肯  | 安肯  | 阿肯  | 
akeng | 凹坑   | 安铿   | 阿坑   | 錒坑  | 錒坑  | 啊坑  | 啊坑  | 按坑  | 按坑  | 爱坑  | 爱坑  | 哎坑  | 哎坑  | 安坑  | 安坑  | 阿坑  | 
akong | 阿空   | 安控   | 錒空  | 錒空  | 啊空  | 啊空  | 按空  | 按空  | 爱空  | 爱空  | 哎空  | 哎空  | 安控  | 阿空  | 奥空  | 奥空  | 
akou | A口   | 拗口   | 暗扣   | 碍口   | 按扣   | 隘口   | 安口   | 錒口  | 錒口  | 啊口  | 啊口  | 按扣  | 爱口  | 爱口  | 哎口  | 哎口  | 
aku | 阿酷   | 爱哭   | 昂库   | 安库   | 爱酷   | 哀苦   | 錒哭  | 錒哭  | 啊哭  | Aku   | 啊哭  | 按哭  | 按哭  | 爱哭  | 哎哭  | 哎哭  | 
akua | 阿夸   | 啊哭啊  | 錒哭啊  | 錒夸  | 錒夸  | 啊夸  | 啊夸  | 按夸  | 按夸  | 爱夸  | 爱夸  | 哎夸  | 哎夸  | 安夸  | 安夸  | 阿夸  | 
akuai | 安快   | 爱快   | 爱哭爱   | 啊哭爱  | 啊哭爱  | 錒哭爱  | 錒哭爱  | 錒快  | 錒快  | 啊快  | 啊快  | 按快  | 按快  | 爱快  | 哎快  | 哎快  | 
akuan | 阿宽   | A款   | 案款   | 矮款   | 啊哭按  | 啊哭按  | 錒哭按  | 錒哭按  | 錒骷按  | 錒骷按  | 啊骷按  | 啊骷按  | 按骷按  | 按骷按  | 爱骷按  | 爱骷按  | 
akuang | 安匡   | 安矿   | 啊哭昂  | 啊哭昂  | 錒哭昂  | 錒哭昂  | 錒狂  | 錒狂  | 啊狂  | 啊狂  | 按狂  | 按狂  | 爱狂  | 爱狂  | 哎狂  | 哎狂  | 
akui | 阿奎   | 阿葵   | 暗亏   | 錒亏  | 錒亏  | 啊亏  | 啊亏  | 按亏  | 按亏  | 爱亏  | 爱亏  | 哎亏  | 哎亏  | 安亏  | 安亏  | 阿奎  | 
akun | 阿坤   | 爱困   | 安坤   | 爱坤   | 錒困  | 錒困  | 啊困  | 啊困  | 按困  | 按困  | 爱困  | 哎困  | 哎困  | 安坤  | 阿坤  | 奥困  | 
akuo | 安阔   | 啊哭哦   | 錒哭哦  | 啊哭哦  | 錒扩  | 錒扩  | 啊扩  | 啊扩  | 按扩  | 按扩  | 爱扩  | 爱扩  | 哎扩  | 哎扩  | 安扩  | 安扩  | 
ala | ala   | 阿拉   | 奥利奥   | 艾力艾   | 安啦   | 奥拉   | 艾拉   | 安拉   | 錒啦  | 啊拉  | ala   | 啊拉  | 按啦  | 按啦  | 爱啦  | 爱啦  | 
alai | 阿莱   | 阿来   | 阿赖   | 奥莱   | 傲来   | 爱来   | 俺来   | 昂莱   | 錒来  | Alain   | 錒来  | 啊来  | 啊来  | 按来  | 按来  | 爱来  | 
alan | Alan   | 阿兰   | 奥利安娜   | 阿蓝   | 阿岚   | 奥莉安娜   | 安澜   | 奥兰   | 爱兰   | 暗蓝   | 安蓝   | 艾岚   | 錒蓝  | 錒蓝  | 啊蓝  | 啊蓝  | 
alang | 阿郎   | 阿狼   | 阿朗   | 爱浪   | 暗狼   | 錒狼  | 錒狼  | 啊狼  | 啊狼  | 按狼  | 按狼  | 爱浪  | 哎狼  | 哎狼  | 安狼  | 安狼  | 
alao | 俺姥   | 安老   | 阿劳   | 啊拉哦  | 錒啦哦  | 錒老  | 錒老  | 啊老  | 啊老  | 按老  | 按老  | 爱老  | 爱老  | 哎老  | 哎老  | 安老  | 
ale | ale   | 阿勒   | 阿乐   | 阿拉尔   | 奥利尔   | 爱丽儿   | 艾露恩   | 按了   | 爱了   | 熬了   | 安乐   | 矮了   | 挨了   | 安了   | 暗了   | 哀乐   | 
alei | A类   | 阿雷   | 阿磊   | 暗雷   | 艾蕾   | 奥雷   | 挨累   | 安磊   | 安雷   | 錒累  | 錒累  | 啊累  | 啊累  | 按累  | 按累  | 爱累  | 
alen | 阿冷   | 阿楞   | 哀乐呢   | ale你  | 阿勒你  | 阿勒你  | Alen   | 阿乐你  | 阿乐你  | 按了你  | 按了你  | 爱了你  | 爱了你  | 熬了你  | 熬了你  | 安乐你  | 
aleng | 阿冷   | 阿楞   | 錒冷  | 錒冷  | 啊冷  | 啊冷  | 按冷  | 按冷  | 爱冷  | 爱冷  | 哎冷  | 哎冷  | 安冷  | 安冷  | 阿冷  | 奥冷  | 
ali | 阿里   | 阿狸   | 阿丽   | 阿力   | Ali   | 阿离   | 阿立   | 阿莉   | 阿黎   | 阿李   | 阿梨   | 案例   | 案例   | 安利   | 安利   | 按理   | 
alia | 阿里啊   | 阿里阿   | 俺俩   | 錒俩  | 錒俩  | alias   | 啊俩  | 啊俩  | 按俩  | 按俩  | 爱俩  | 爱俩  | 哎俩  | 哎俩  | 安俩  | 安俩  | 
alian | 阿莲   | 阿联   | 阿连   | 暗恋   | 爱恋   | 安联   | 爱怜   | 爱联   | 爱莲   | 奥联   | 哀怜   | 暗链   | 谙练   | 爱链   | 錒连  | 錒连  | 
aliang | 阿亮   | 阿良   | 阿梁   | 阿凉   | 按量   | 暗梁   | 安良   | 安粮   | 艾亮   | 安亮   | 錒两  | 錒两  | 啊两  | 啊两  | 按量  | 爱两  | 
aliao | 阿里奥   | 奥利奥   | 爱聊   | 安辽   | 啊俩哦  | 錒俩哦  | 阿里阿哦  | 阿里啊哦  | 錒聊  | 錒聊  | 啊聊  | 啊聊  | 按聊  | 按聊  | 爱聊  | 哎聊  | 
alie | 啊咧   | 阿列   | 案例额   | 案列   | 錒列  | 錒列  | alien   | 啊咧  | 按列  | 按列  | 爱列  | 爱列  | 哎列  | 哎列  | 安列  | 安列  | 
alin | 阿林   | 阿琳   | 阿里那   | 奥林   | 艾琳   | 安林   | 爱林   | 澳林   | 挨淋   | 爱琳   | 安琳   | 艾林   | 錒林  | 錒林  | Alina   | 啊林  | 
aling | 阿玲   | 阿绫   | 阿灵   | 阿零   | 爱玲   | 按铃   | 奥铃   | 安岭   | 安玲   | 安陵   | 爱灵   | 錒领  | 錒领  | 啊领  | 啊领  | 按铃  | 
aliu | 阿六   | 阿瑠   | 暗流   | 安流   | 癌瘤   | 錒留  | 錒留  | 啊留  | 啊留  | 按留  | 按留  | 爱留  | 爱留  | 哎留  | 哎留  | 安流  | 
alo | 安咯   | alone   | 艾利欧   | 錒咯  | 啊咯  | 啊咯  | alone   | 按咯  | 按咯  | 爱咯  | 爱咯  | 哎咯  | 哎咯  | 安咯  | 阿咯  | 阿咯  | 
along | 阿龙   | along   | 阿隆   | 安龙   | 奥龙   | 澳龙   | 暗龙   | 傲龙   | 爱龙   | 安隆   | 獒龙   | 錒龙  | 錒龙  | 啊龙  | 啊龙  | 按龙  | 
alou | 阿露   | 錒楼  | 錒楼  | 啊楼  | aloud   | 啊楼  | 按楼  | 按楼  | 爱楼  | 爱楼  | 哎楼  | 哎楼  | 安楼  | 安楼  | 阿露  | 奥楼  | 
alu | 阿鲁   | 阿露   | 阿卢   | 阿鹿   | aluminum   | 安陆   | 安路   | 奥卢   | 艾路   | 隘路   | 艾露   | 錒路  | 錒路  | 啊路  | 啊路  | 按路  | 
aluan | 爱乱   | 安鸾   | 啊路按  | 啊路按  | 錒路按  | 錒路按  | 錒乱  | 錒乱  | 啊乱  | 啊乱  | 按乱  | 按乱  | 爱乱  | 哎乱  | 哎乱  | 安乱  | 
alun | 阿伦   | 氨纶   | 艾伦   | 奥伦   | 爱伦   | 錒轮  | 錒轮  | 啊轮  | 啊轮  | 按轮  | 按轮  | 爱伦  | 哎轮  | 哎轮  | 安轮  | 安轮  | 
aluo | 阿罗   | 阿洛   | 爱罗   | 奥罗   | 安洛   | 艾罗   | 傲罗   | 暗萝   | 啊路哦  | 錒路哦  | 錒罗  | 錒罗  | 啊罗  | 啊罗  | 按罗  | 按罗  | 
alv | 阿绿   | 阿驴   | 氨氯   | 爱侣   | 哀绿   | 爱绿   | 錒绿  | 錒绿  | Alvin   | 啊绿  | 啊绿  | 按绿  | 按绿  | 爱侣  | 哎绿  | 哎绿  | 
alve | 安略   | 阿驴额   | 啊绿额  | 啊绿额  | 錒绿额  | 錒绿额  | 錒驴额  | 錒驴额  | 啊驴额  | 啊驴额  | 按驴额  | 按驴额  | 爱驴额  | 爱驴额  | 哎驴额  | 哎驴额  | 
am | am   | 按摩   | 澳门   | 艾玛   | 暧昧   | 挨骂   | 阿妈   | 俺们   | 阿门   | 俺妈   | 奥秘   | 爱美   | 阿迷   | 俺么   | 阿么   | 傲慢   | 
ama | 阿妈   | 啊嘛   | 阿玛   | 艾玛啊   | 阿马   | AMA   | 艾玛   | 挨骂   | 俺妈   | 奥玛   | 爱玛   | 爱吗   | 奥马   | 暗骂   | 哎嘛   | 鞍马   | 
amai | 阿麦   | 爱买   | 按脉   | 爱迈   | 安迈   | 爱麦   | 錒买  | 錒买  | 啊买  | 啊买  | 按脉  | 爱买  | 哎买  | 哎买  | 安迈  | 阿麦  | 
aman | 阿曼   | 阿满   | 阿蛮   | 阿妈呢   | 傲慢   | 安曼   | 安满   | 艾曼   | 錒慢  | Amanda   | 錒慢  | 啊慢  | 啊慢  | 按慢  | 按慢  | 爱慢  | 
amang | 澳芒   | 阿芒   | 錒忙  | 錒忙  | 啊忙  | 啊忙  | 按忙  | 按忙  | 爱忙  | 爱忙  | 哎忙  | 哎忙  | 安忙  | 安忙  | 阿芒  | 奥忙  | 
amao | 阿毛   | 阿猫   | 阿茂   | 澳毛   | 爱猫   | 安茂   | 暗猫   | 錒毛  | 錒毛  | 啊毛  | 啊毛  | 按毛  | 按毛  | 爱猫  | 哎毛  | 哎毛  | 
ame | 阿么   | 艾麦尔   | 埃米尔   | 阿米尔   | 艾买尔   | 爱弥儿   | 阿木尔   | 阿穆尔   | 奥马尔   | 俺么   | 爱么   | 錒么  | 錒么  | 啊么  | AME   | 啊么  | 
amei | 阿妹   | 阿梅   | 阿美   | 暧昧   | 爱美   | 奥美   | 艾美   | 俺妹   | 安美   | 澳美   | 爱梅   | 奥妹   | 爱妹   | 暗昧   | 俺没   | 錒没  | 
amen | 阿门   | Amen   | 澳门   | 俺们   | 暗门   | 挨门   | 錒们  | 錒们  | 啊们  | 啊们  | 按们  | 按们  | 爱们  | 爱们  | 哎们  | 哎们  | 
ameng | 阿蒙   | 阿梦   | 阿萌   | 阿盟   | 阿猛   | 安盟   | 爱梦   | 奥盟   | 安梦   | 爱蒙   | 安萌   | 挨蒙   | 錒梦  | 錒梦  | 啊梦  | 啊梦  | 
ami | 阿迷   | 阿米   | 阿咪   | 阿蜜   | amid   | A米   | 奥秘   | 艾米   | 安谧   | 安米   | 埃米   | 奥密   | 錒米  | 錒米  | 啊米  | 啊米  | 
amian | A面   | 安眠   | 凹面   | 爱面   | 暗面   | 啊米按  | 啊米按  | 錒米按  | 錒米按  | 錒面  | 錒面  | 啊面  | 啊面  | 按面  | 按面  | 爱面  | 
amiao | 阿喵   | 阿苗   | 啊喵   | 阿妙   | 奥妙   | 啊米奥  | 啊米奥  | 錒米奥  | 錒米奥  | 錒秒  | 錒秒  | 啊喵  | 按秒  | 按秒  | 爱秒  | 爱秒  | 
amie | 暗灭   | 黯灭   | 鏖灭   | Amie   | 啊米额  | 錒米额  | 錒米额  | Amie   | 錒迷额  | 錒迷额  | 啊迷额  | 啊迷额  | 按迷额  | 按迷额  | 爱迷额  | 爱迷额  | 
amin | 阿敏   | 阿民   | 阿米南   | 爱民   | 安民   | 安敏   | 艾敏   | 錒min  | 啊min  | Amin   | 按min  | 爱min  | 哎min  | 安min  | 阿min  | 奥min  | 
aming | 阿明   | 阿铭   | 案名   | 爱明   | 敖明   | 安明   | 哀鸣   | 錒名  | 錒名  | 啊名  | 啊名  | 按名  | 按名  | 爱明  | 哎名  | 哎名  | 
amiu | 爱缪   | 安缪   | 錒谬  | 錒谬  | 啊谬  | 啊谬  | 按谬  | 按谬  | 爱谬  | 爱谬  | 哎谬  | 哎谬  | 安谬  | 安谬  | 阿谬  | 阿谬  | 
amo | 阿莫   | 阿嬷   | 阿默   | 阿陌   | Amo   | 按摩   | 奥摩   | 熬磨   | 哀默   | 艾莫   | 安陌   | 鏖魔   | 錒摸  | 錒摸  | 啊摸  | 啊摸  | 
amou | amount   | 錒某  | 啊某  | 啊某  | amount   | 按某  | 按某  | 爱某  | 爱某  | 哎某  | 哎某  | 安某  | 安某  | 阿某  | 阿某  | 奥某  | 
amu | 阿木   | 阿姆   | 阿母   | 阿穆   | amuse   | 阿沐   | 爱慕   | 暗牧   | 凹模   | 桉木   | 案目   | 錒木  | 錒木  | 啊木  | 啊木  | 凹模   | 
an | 按   | 安   | 俺   | 暗   | an   | 案   | 岸   | 氨   | 庵   | 胺   | 鞍   | 黯   | 铵   | 桉   | 谙   | 唵   | 
ana | 阿娜   | 爱你啊   | 婀娜   | 錒那  | 錒那  | Ana   | 啊那  | 啊那  | 按啊  | 安啊  | 阿娜  | an啊  | 俺啊  | 暗啊  | 案啊  | 吖那  | 
anai | 阿奶   | 阿耐   | 錒奶  | 錒奶  | 啊奶  | 啊奶  | 按爱  | 按爱  | 安爱  | 安爱  | 阿奶  | an爱  | 俺爱  | 俺爱  | 暗爱  | 暗爱  | 
anan | 安安   | 暗暗   | 按按   | 阿南   | 阿楠   | 阿男   | 錒奶啊奶   | 吖那錒奶   | 啊那吖那   | 錒那啊那   | 錒男  | 錒男  | 啊男  | 錒男  | 吖那錒奶   | 啊那吖那   | 
anang | 安昂   | 錒囊  | 錒囊  | 啊囊  | 啊囊  | 按昂  | 按昂  | 安昂  | 阿囊  | 阿囊  | an昂  | 俺昂  | 俺昂  | 暗昂  | 暗昂  | 案昂  | 
anao | 阿瑙   | 吖那哦  | 啊那哦  | 錒那哦  | 錒闹  | 錒闹  | 啊闹  | 啊闹  | 按奥  | 按奥  | 安奥  | 安奥  | 阿瑙  | an奥  | Ana哦  | 俺奥  | 
ane | 媕娿   | 奥尼尔   | 安奈儿   | 阿娜尔   | 爱你哦   | 錒呢  | 錒呢  | 啊呢  | anew   | 啊呢  | 按额  | 按额  | 安额  | 安额  | 爱你哦   | 阿呢  | 
anei | 阿内   | 錒内  | 錒内  | 啊内  | 啊内  | 按诶  | 按诶  | 安诶  | 安诶  | 阿内  | an诶  | 俺诶  | 俺诶  | 暗诶  | 暗诶  | 案诶  | 
anen | 安恩   | 錒嫩  | 錒嫩  | 啊嫩  | 啊嫩  | 按嗯  | 按嗯  | 安恩  | 阿嫩  | 阿嫩  | an嗯  | 俺嗯  | 俺嗯  | 暗嗯  | 暗嗯  | 案嗯  | 
aneng | 阿能   | 錒能  | 錒能  | 啊能  | 啊能  | 按鞥  | 按鞥  | 安鞥  | 安鞥  | 阿能  | an鞥  | 俺鞥  | 俺鞥  | 暗鞥  | 暗鞥  | 案鞥  | 
ang | 昂   | 安个   | 俺个   | 暗个   | 案个   | 岸个   | 氨个   | 庵个   | 按个   | 阿牛哥   | 盎   | 肮   | 卬   | angel   | 岇   | 枊   | 
ani | 阿尼   | 阿妮   | 啊你   | 錒你  | animal   | 錒你  | 啊你  | 阿尼  | 吖你  | 吖你  | 嗄你  | 嗄你  | 锕你  | 锕你  | 腌你  | 腌你  | 
ania | 阿年   | 阿娘   | 腌你啊  | 锕你啊  | 嗄你啊  | 吖你啊  | 錒你啊  | 阿尼啊  | 阿妮啊  | 啊你啊  | 錒年  | 錒年  | 啊年  | 啊年  | 阿年  | 吖年  | 
anian | 吖年   | 啊年   | 錒年   | 阿年   | 腌你按  | 啊你按   | 腌你按  | 锕你按  | 锕你按  | 嗄你按  | 嗄你按  | 吖你按  | 吖你按  | 錒你按  | 錒你按  | 錒你按  | 
aniang | 阿娘   | 腌你昂  | 腌你昂  | 锕你昂  | 锕你昂  | 嗄你昂  | 嗄你昂  | 吖你昂  | 吖你昂  | 錒你昂  | 錒你昂  | 錒霓昂  | 錒霓昂  | 啊霓昂  | 啊霓昂  | 阿娘  | 
aniao | 阿尼奥   | 腌你奥  | 腌你奥  | 锕你奥  | 锕你奥  | 嗄你奥  | 嗄你奥  | 錒你奥  | 吖你奥  | 錒你奥  | 吖你奥  | 錒腻奥  | 錒腻奥  | 啊腻奥  | 啊腻奥  | 阿尼奥  | 
anie | 啊捏   | 腌你额  | 阿尼额   | 腌你额  | 锕你额  | 腌你额  | 嗄你额  | 嗄你额  | 吖你额  | 錒你额  | 嗄你额  | 吖你额  | 錒捏  | 錒捏  | 啊捏  | 阿捏  | 
anin | 啊你你   | 阿尼你   | 錒nin  | 啊nin  | 阿nin  | 吖nin  | 嗄nin  | 锕nin  | 腌nin  | 醃nin  | 呵nin  | 按in  | 安in  | anin  | 俺in  | 暗in  | 
aning | 阿宁   | 錒宁  | 錒宁  | 啊宁  | 啊宁  | 阿宁  | 吖宁  | 吖宁  | 嗄宁  | 嗄宁  | 锕宁  | 锕宁  | 腌宁  | 腌宁  | 醃宁  | 醃宁  | 
aniu | 阿牛   | 錒牛  | 錒牛  | 啊牛  | 啊牛  | 阿牛  | 吖牛  | 吖牛  | 嗄牛  | 嗄牛  | 锕牛  | 锕牛  | 腌牛  | 腌牛  | 醃牛  | 醃牛  | 
anong | 阿侬   | 錒弄  | 錒弄  | 啊弄  | 啊弄  | 阿侬  | 吖弄  | 吖弄  | 嗄弄  | 嗄弄  | 锕弄  | 锕弄  | 腌弄  | 腌弄  | 醃弄  | 醃弄  | 
anou | 阿耨   | 錒耨  | 錒耨  | 啊耨  | 啊耨  | 按偶  | 按偶  | 安偶  | 安偶  | 阿耨  | an偶  | 俺偶  | 俺偶  | 暗偶  | 暗偶  | 案偶  | 
anu | 阿奴   | 錒怒  | 錒怒  | 啊怒  | anus   | 啊怒  | 阿奴  | 吖怒  | 吖怒  | 嗄怒  | 嗄怒  | 锕怒  | 锕怒  | 腌怒  | 腌怒  | 醃怒  | 
anuan | 阿暖   | 醃怒按  | 阿奴按   | 醃怒按  | 腌怒按  | 腌怒按  | 锕怒按  | 锕怒按  | 嗄怒按  | 嗄怒按  | 吖怒按  | 吖怒按  | 啊怒按  | 啊怒按  | 錒怒按  | 錒怒按  | 
anun | 阿奴你   | 錒nun  | 啊nun  | 阿nun  | 吖nun  | 嗄nun  | 锕nun  | 腌nun  | 醃nun  | 呵nun  | 按UN  | 安UN  | anUN  | 俺UN  | 暗UN  | 案UN  | 
anuo | 阿诺   | 婀娜   | 醃怒哦  | 腌怒哦  | 锕怒哦  | 嗄怒哦  | 吖怒哦  | 啊怒哦  | 錒怒哦  | 錒诺  | 錒诺  | 啊诺  | 啊诺  | 阿诺  | 吖诺  | 吖诺  | 
anv | 阿女   | 錒女  | 錒女  | 啊女  | anvil   | 啊女  | 阿女  | 吖女  | 吖女  | 嗄女  | 嗄女  | 锕女  | 锕女  | 腌女  | 腌女  | 醃女  | 
anve | 阿钕额   | 醃女额  | 醃女额  | 腌女额  | 腌女额  | 锕女额  | 锕女额  | 嗄女额  | 嗄女额  | 吖女额  | 吖女额  | 啊女额  | 啊女额  | 錒女额  | 錒女额  | 錒钕额  | 
ao | 奥   | 熬   | 傲   | ┗|｀O′|┛ 嗷~~   | 凹   | 澳   | 袄   | 嗷   | 敖   | 坳   | 啊哦   | 拗   | 鳌   | 獒   | 岙   | 翱   | 
aou | 阿偶   | 阿欧   | 錒偶  | 錒偶  | 啊偶  | 啊偶  | 阿偶  | 吖偶  | 吖偶  | 嗄偶  | 嗄偶  | 锕偶  | 锕偶  | 腌偶  | 腌偶  | 醃偶  | 
apa | 阿帕   | 俺怕   | 奥帕   | 錒怕  | 錒怕  | 啊怕  | APA   | 啊怕  | 按怕  | 按怕  | 爱怕  | 爱怕  | 哎怕  | 哎怕  | 安怕  | 安怕  | 
apai | 安排   | 爱拍   | 奥派   | 爱派   | 暗拍   | 艾派   | 暗牌   | 阿派   | 錒拍  | 錒拍  | 啊拍  | 啊拍  | 按拍  | 按拍  | 爱拍  | 哎拍  | 
apan | A盘   | 阿潘   | 阿胖   | 暗盘   | 安胖   | 錒pan  | 啊pan  | 按pan  | 爱pan  | 哎pan  | 安pan  | 阿pan  | 奥pan  | 唉pan  | 昂pan  | 熬pan  | 
apang | 阿胖   | 阿房   | 矮胖   | 奥胖   | 安胖   | 錒胖  | 錒胖  | 啊胖  | 啊胖  | 按胖  | 按胖  | 爱胖  | 爱胖  | 哎胖  | 哎胖  | 安胖  | 
apao | 阿泡   | 挨炮   | 岸炮   | 爱跑   | 傲跑   | 暗炮   | 凹刨   | 啊怕哦  | 錒怕哦  | 錒跑  | 錒跑  | 啊跑  | 啊跑  | 按跑  | 按跑  | 爱跑  | 
apei | 啊呸   | 阿佩   | 安培   | 癌胚   | 暗配   | 錒陪  | 錒陪  | 啊呸  | 按陪  | 按陪  | 爱陪  | 爱陪  | 哎陪  | 哎陪  | 安培  | 阿佩  | 
apen | 阿喷   | 錒喷  | 錒喷  | 啊喷  | 啊喷  | 按喷  | 按喷  | 爱喷  | 爱喷  | 哎喷  | 哎喷  | 安喷  | 安喷  | 阿喷  | 奥喷  | 奥喷  | 
apeng | 阿鹏   | 奥鹏   | 艾蓬   | 安鹏   | 艾鹏   | 爱朋   | 錒碰  | 錒碰  | 啊碰  | 啊碰  | 按碰  | 按碰  | 爱朋  | 哎碰  | 哎碰  | 安鹏  | 
api | 挨批   | 暗批   | API   | 錒屁  | 啊屁  | 啊屁  | API   | 按屁  | 按屁  | 爱屁  | 爱屁  | 哎屁  | 哎屁  | 安屁  | 安屁  | 阿屁  | 
apian | A片   | 阿片   | 挨骗   | 阿屁按  | 阿屁按  | 啊屁按  | 啊屁按  | 錒屁按  | 錒屁按  | 錒片  | 錒片  | 啊片  | 錒片  | 啊片  | 按片  | 按片  | 
apiao | 阿飘   | 暗票   | 阿屁奥  | 阿屁奥  | 啊屁奥  | 啊屁奥  | 錒屁奥  | 錒屁奥  | 錒票  | 錒票  | 啊票  | 啊票  | 按票  | 按票  | 爱票  | 爱票  | 
apie | apiece   | 阿屁额  | 啊屁额  | 啊屁额  | apiece   | 錒屁额  | 錒屁额  | 錒辟额  | 錒辟额  | 啊辟额  | 啊辟额  | 按辟额  | 按辟额  | 爱辟额  | 爱辟额  | 哎辟额  | 
apin | 爱拼   | 安贫   | 安品   | 錒品  | 錒品  | 啊品  | 啊品  | 按品  | 按品  | 爱拼  | 哎品  | 哎品  | 安贫  | 阿品  | 阿品  | 奥品  | 
aping | 阿平   | 阿萍   | A屏   | 安平   | 安瓶   | 安评   | 爱平   | 爱萍   | 昂坪   | 敖平   | 錒ping  | 啊ping  | 按ping  | 爱ping  | 哎ping  | 安ping  | 
apo | 阿婆   | 安珀   | 岸坡   | 錒破  | 錒破  | 啊破  | APO   | 啊破  | 按破  | 按破  | 爱破  | 爱破  | 哎破  | 哎破  | 安珀  | 阿婆  | 
apou | 阿剖   | 錒剖  | 錒剖  | 啊剖  | 啊剖  | 按剖  | 按剖  | 爱剖  | 爱剖  | 哎剖  | 哎剖  | 安剖  | 安剖  | 阿剖  | 奥剖  | 奥剖  | 
apu | 阿噗   | 阿普   | 啊噗   | 奥普   | 安普   | 爱普   | 艾普   | 安谱   | 安铺   | 爱谱   | 安朴   | 錒铺  | APU   | 錒铺  | 啊噗  | 按铺  | 
aqi | 阿奇   | 阿七   | 阿琪   | 阿旗   | 阿齐   | 按期   | 安琪   | 暗器   | 爱妻   | 奥奇   | 傲气   | 氨气   | 爱奇   | 嗳气   | 艾奇   | 安琦   | 
aqia | 奥恰   | 阿恰   | 錒掐  | 錒掐  | 啊掐  | 啊掐  | 按掐  | 按掐  | 爱掐  | 爱掐  | 哎掐  | 哎掐  | 安掐  | 安掐  | 阿恰  | 奥恰  | 
aqian | 阿倩   | 阿前   | 爱钱   | 安茜   | 錒钱  | 錒钱  | 啊钱  | 啊钱  | 按钱  | 按钱  | 爱钱  | 哎钱  | 哎钱  | 安茜  | 阿倩  | 奥钱  | 
aqiang | 阿强   | 暗强   | 爱强   | 矮墙   | 暗枪   | 安强   | 奥强   | 艾强   | 錒强  | 錒强  | 啊强  | 啊强  | 按强  | 按强  | 爱强  | 哎强  | 
aqiao | 阿悄   | 阿巧   | 阿乔   | 安桥   | 岸桥   | 啊掐哦  | 錒掐哦  | 阿恰哦  | 錒桥  | 錒桥  | 啊桥  | 啊桥  | 按桥  | 按桥  | 爱桥  | 爱桥  | 
aqie | 爱妾   | 哀切   | 奥切   | 安切   | 安锲   | 錒切  | 錒切  | 啊切  | 啊切  | 按切  | 按切  | 爱妾  | 哎切  | 哎切  | 安切  | 阿切  | 
aqin | 阿沁   | 阿琴   | 阿钦   | 吖嗪   | 爱琴   | 安寝   | 安亲   | 安琴   | 安沁   | 錒亲  | 錒亲  | 啊亲  | 啊亲  | 按亲  | 按亲  | 爱琴  | 
aqing | 阿青   | 阿清   | 阿庆   | 阿晴   | 爱情   | 安庆   | 案情   | 爱卿   | 艾青   | 爱清   | 安晴   | 安青   | 安清   | 錒请  | 錒请  | 啊请  | 
aqiong | 阿琼   | 錒穷  | 錒穷  | 啊穷  | 啊穷  | 按穷  | 按穷  | 爱穷  | 爱穷  | 哎穷  | 哎穷  | 安穷  | 安穷  | 阿琼  | 奥穷  | 奥穷  | 
aqiu | 阿秋   | 阿丘   | 安丘   | 奥球   | 哀求   | 爱囚   | 挨球   | 錒求  | 錒求  | 啊求  | 啊求  | 按求  | 按求  | 爱囚  | 哎求  | 哎求  | 
aqu | A区   | 阿区   | 俺去   | 爱去   | 奥曲   | 暗区   | 暗渠   | 氨区   | 爱趣   | 錒去  | 錒去  | Aqua   | 啊去  | 啊去  | 按去  | 按去  | 
aquan | 阿全   | 阿权   | 安全   | 爱犬   | 獒犬   | 啊去按  | 啊去按  | 錒去按  | 錒去按  | 錒曲安  | 錒曲安  | 啊曲安  | 啊曲安  | 按曲安  | 按曲安  | 爱曲安  | 
aque | aqueous   | 啊去额  | 錒去额  | 錒去额  | aqueous   | 錒却  | 錒却  | 啊却  | 啊却  | 按却  | 按却  | 爱却  | 爱却  | 哎却  | 哎却  | 安却  | 
aqun | 阿群   | 安群   | 爱群   | 袄裙   | 錒群  | 錒群  | 啊群  | 啊群  | 按群  | 按群  | 爱群  | 哎群  | 哎群  | 安群  | 阿群  | 奥群  | 
aran | Aran   | 阿然   | 安然   | 盎然   | 黯然   | 傲然   | 安冉   | 蔼然   | 昂然   | 岸然   | 錒然  | 啊然  | Aran   | 啊然  | 按然  | 按然  | 
arang | 爱让   | 阿让   | 錒rang  | 啊rang  | 按rang  | 爱rang  | 哎rang  | 安rang  | 阿rang  | 奥rang  | 唉rang  | 昂rang  | 熬rang  | 俺rang  | 暗rang  | 案rang  | 
arao | 啊绕   | 錒绕  | 錒绕  | 啊绕  | 按绕  | 按绕  | 爱绕  | 爱绕  | 哎绕  | 哎绕  | 安绕  | 安绕  | 阿绕  | 阿绕  | 奥绕  | 奥绕  | 
are | are   | 阿热   | 艾热   | 昂热   | 錒re  | 啊re  | 按re  | 爱re  | 哎re  | 安re  | 阿re  | 奥re  | 唉re  | 昂re  | 熬re  | 俺re  | 
aren | arena   | 阿忍   | 爱人   | 安仁   | 矮人   | 傲人   | 熬人   | 按人   | 暗刃   | 昂仁   | 安人   | 安忍   | 錒人  | 啊人  | arena   | 啊人  | 
areng | 矮人国   | 錒扔  | 錒扔  | 啊扔  | 啊扔  | 按扔  | 按扔  | 爱扔  | 爱扔  | 哎扔  | 哎扔  | 安扔  | 安扔  | 阿扔  | 阿扔  | 奥扔  | 
ari | Ari   | 阿日   | 奥日   | 艾日   | 錒日  | 啊日  | Ari   | 啊日  | 按日  | 按日  | 爱日  | 爱日  | 哎日  | 哎日  | 安日  | 安日  | 
arong | 阿荣   | 阿容   | 阿蓉   | 艾绒   | 安荣   | 爱荣   | 哀荣   | 錒荣  | 錒荣  | 啊荣  | 啊荣  | 按荣  | 按荣  | 爱荣  | 哎荣  | 哎荣  | 
arou | around   | 阿柔   | 按揉   | 錒肉  | 啊肉  | around   | 啊肉  | 按揉  | 爱肉  | 爱肉  | 哎肉  | 哎肉  | 安肉  | 安肉  | 阿柔  | 奥肉  | 
aru | 阿如   | 爱如   | 錒如  | 錒如  | 啊如  | 啊如  | 按如  | 按如  | 爱如  | 哎如  | 哎如  | 安如  | 安如  | 阿如  | 奥如  | 奥如  | 
arua | 阿软   | 啊如啊   | 錒如啊  | 錒挼  | 錒挼  | 啊挼  | 啊挼  | 按挼  | 按挼  | 爱挼  | 爱挼  | 哎挼  | 哎挼  | 安挼  | 安挼  | 阿挼  | 
aruan | 阿软   | 啊如按  | 啊如按  | 錒如按  | 錒如按  | 錒如按  | 啊如按  | 按如按  | 按如按  | 爱如按  | 爱如按  | 哎如按  | 哎如按  | 安如按  | 安如按  | 阿如按  | 
arui | 阿瑞   | 阿睿   | 艾瑞   | 安瑞   | 奥瑞   | 艾睿   | 錒瑞  | 錒瑞  | 啊瑞  | 啊瑞  | 按瑞  | 按瑞  | 爱瑞  | 爱瑞  | 哎瑞  | 哎瑞  | 
arun | 安润   | 奥润   | 阿润   | 錒润  | 錒润  | 啊润  | 啊润  | 按润  | 按润  | 爱润  | 爱润  | 哎润  | 哎润  | 安润  | 阿润  | 奥润  | 
aruo | 阿箬   | 安若   | 暗弱   | 啊如哦  | 錒如哦  | 錒若  | 錒若  | 啊若  | 啊若  | 按若  | 按若  | 爱若  | 爱若  | 哎若  | 哎若  | 安若  | 
asa | 阿萨   | 阿Sa   | 艾萨   | 俺仨   | 奥萨   | 錒撒  | 錒撒  | ASA   | 啊撒  | 啊撒  | 按撒  | 按撒  | 爱撒  | 爱撒  | 哎撒  | 哎撒  | 
asai | 奥赛   | 埃塞   | 安塞   | 阿塞   | 錒赛  | 錒赛  | 啊赛  | 啊赛  | 按赛  | 按赛  | 爱赛  | 爱赛  | 哎赛  | 哎赛  | 安塞  | 阿塞  | 
asan | 阿三   | 俺三   | 爱三   | 錒三  | 錒三  | 啊三  | 啊三  | 按三  | 按三  | 爱三  | 哎三  | 哎三  | 安三  | 安三  | 阿三  | 奥三  | 
asang | 阿桑   | 懊丧   | 錒sang  | 啊sang  | 按sang  | 爱sang  | 哎sang  | 安sang  | 阿sang  | 奥sang  | 唉sang  | 昂sang  | 熬sang  | 俺sang  | 暗sang  | 案sang  | 
asao | 阿嫂   | 啊撒哦  | 錒撒哦  | 錒扫  | 錒扫  | 啊扫  | 啊扫  | 按扫  | 按扫  | 爱扫  | 爱扫  | 哎扫  | 哎扫  | 安扫  | 安扫  | 阿嫂  | 
ase | 阿瑟   | 碍事儿   | 安塞尔   | 阿色   | 安思尔   | 阿萨尔   | 阿苏尔   | 奥赛尔   | 暗色   | 爱色   | 錒色  | ASE   | 錒色  | 啊色  | 啊色  | 按色  | 
asen | 阿森   | 奥森   | 艾森   | 爱森   | 安森   | 澳森   | 錒森  | 錒森  | 啊森  | 啊森  | 按森  | 按森  | 爱森  | 哎森  | 哎森  | 安森  | 
aseng | 阿僧   | 錒僧  | 錒僧  | 啊僧  | 啊僧  | 按僧  | 按僧  | 爱僧  | 爱僧  | 哎僧  | 哎僧  | 安僧  | 安僧  | 阿僧  | 奥僧  | 奥僧  | 
asha | 阿莎   | 阿沙   | 暗杀   | 爱莎   | 艾莎   | 奥沙   | 艾沙   | 安厦   | 安沙   | 爱杀   | 安莎   | 暗沙   | 錒啥  | 錒啥  | Asha   | 啊啥  | 
ashai | 爱晒   | 錒晒  | 錒晒  | 啊晒  | 啊晒  | 按晒  | 按晒  | 爱晒  | 哎晒  | 哎晒  | 安晒  | 安晒  | 阿晒  | 阿晒  | 奥晒  | 奥晒  | 
ashan | 阿山   | 阿珊   | 鞍山   | 艾山   | 奥山   | 安山   | 鳌山   | 爱山   | 昂山   | 爱善   | 錒山  | 錒山  | 啊山  | 啊山  | 按山  | 按山  | 
ashang | 爱上   | 岸上   | 爱尚   | 按上   | 安上   | 哀伤   | 熬上   | 艾尚   | 爱殇   | 暗伤   | 阿上   | 錒上  | 錒上  | 啊上  | 啊上  | 按上  | 
ashao | 暗哨   | 安少   | 安绍   | 啊啥哦  | 錒啥哦  | 錒少  | 錒少  | 啊少  | 啊少  | 按少  | 按少  | 爱少  | 爱少  | 哎少  | 哎少  | 安少  | 
ashe | 阿舍   | 安设   | 爱舍   | 暗射   | 錒设  | 錒设  | 啊设  | Asher   | 啊设  | 按设  | 按设  | 爱舍  | 哎设  | 哎设  | 安设  | 阿舍  | 
ashei | 爱谁   | 阿谁   | 錒谁  | 錒谁  | 啊谁  | 啊谁  | 按谁  | 按谁  | 爱谁  | 哎谁  | 哎谁  | 安谁  | 安谁  | 阿谁  | 奥谁  | 奥谁  | 
ashen | ashen   | 阿婶   | 阿神   | 安神   | 爱神   | 安身   | 奥神   | 奥申   | 暗神   | 錒神  | ashen   | 啊神  | 啊神  | 按神  | 按神  | 爱神  | 
asheng | 阿生   | 阿胜   | 阿笙   | 安生   | 安盛   | 爱生   | 唉声   | 奥盛   | 傲胜   | 安胜   | 安省   | 昂生   | 奥圣   | 安笙   | 錒生  | 錒生  | 
ashi | 阿是   | 啊是   | 阿诗   | 阿施   | 阿时   | 按时   | 暗示   | 爱是   | 傲视   | 碍事   | 按实   | 俺是   | 安市   | 安适   | 傲世   | 暗室   | 
ashou | 阿兽   | 昂首   | 案首   | 奥兽   | 碍手   | 錒收  | 錒收  | 啊收  | 啊收  | 按收  | 按收  | 爱收  | 爱收  | 哎收  | 哎收  | 安收  | 
ashu | 阿叔   | 阿树   | 阿数   | 奥数   | 桉树   | 奥术   | 爱书   | 俺叔   | 谙熟   | 矮树   | 錒书  | 錒书  | 啊书  | 啊书  | 按书  | 按书  | 
ashua | 爱耍   | 啊书啊  | 錒书啊  | 錒刷  | 錒刷  | 啊刷  | 啊刷  | 按刷  | 按刷  | 爱耍  | 哎刷  | 哎刷  | 安刷  | 安刷  | 阿刷  | 阿刷  | 
ashuai | 阿衰   | 阿帅   | 安帅   | 奥帅   | 啊书爱  | 啊书爱  | 錒书爱  | 錒书爱  | 錒鼠爱  | 錒鼠爱  | 啊鼠爱  | 啊鼠爱  | 按鼠爱  | 按鼠爱  | 爱鼠爱  | 爱鼠爱  | 
ashuan | 癌栓   | 安栓   | 啊书按  | 啊书按  | 錒书按  | 錒书按  | 錒鼠按  | 錒鼠按  | 啊鼠按  | 啊鼠按  | 按鼠按  | 按鼠按  | 爱鼠按  | 爱鼠按  | 哎鼠按  | 哎鼠按  | 
ashuang | 阿爽   | 阿双   | 暗爽   | 傲霜   | 啊书昂  | 啊书昂  | 錒书昂  | 錒书昂  | 錒输昂  | 錒输昂  | 啊输昂  | 啊输昂  | 按输昂  | 按输昂  | 爱输昂  | 爱输昂  | 
ashui | 阿水   | 氨水   | 爱谁   | 安睡   | 熬水   | 爱睡   | 爱水   | 錒谁  | 錒谁  | 啊谁  | 啊谁  | 按谁  | 按谁  | 爱谁  | 哎谁  | 哎谁  | 
ashun | 安顺   | 阿顺   | 錒顺  | 錒顺  | 啊顺  | 啊顺  | 按顺  | 按顺  | 爱顺  | 爱顺  | 哎顺  | 哎顺  | 安顺  | 阿顺  | 奥顺  | 奥顺  | 
ashuo | 按说   | 爱说   | 挨说   | 安硕   | 俺说   | 錒书哦  | 啊书哦  | 錒说  | 錒说  | 啊说  | 啊说  | 按说  | 爱说  | 哎说  | 哎说  | 安硕  | 
asi | 阿斯   | 阿肆   | 阿四   | 阿巳   | ASI   | 爱思   | 爱死   | 艾斯   | 奥斯   | 盎司   | 熬死   | 哀思   | 安斯   | 艾思   | 艾丝   | 爱四   | 
asong | 阿松   | 爱松   | 奥松   | 暗送   | 錒送  | 錒送  | 啊送  | 啊送  | 按送  | 按送  | 爱松  | 哎送  | 哎送  | 安送  | 安送  | 阿松  | 
asou | 爱搜   | 啊搜   | 錒sou  | 啊sou  | 按sou  | 爱sou  | 哎sou  | 安sou  | 阿sou  | 奥sou  | 唉sou  | 昂sou  | 熬sou  | 俺sou  | 暗sou  | 案sou  | 
asu | 阿苏   | 安苏   | 安素   | 昂素   | 安速   | 錒苏  | 錒苏  | 啊苏  | ASU   | 啊苏  | 按苏  | 按苏  | 爱苏  | 爱苏  | 哎苏  | 哎苏  | 
asuan | 暗算   | 氨酸   | 嗳酸   | 爱算   | 安素安   | 啊苏按  | 啊苏按  | 錒苏按  | 錒苏按  | 錒酥按  | 錒酥按  | 啊酥按  | 啊酥按  | 按酥按  | 按酥按  | 爱酥按  | 
asui | 安穗   | 按碎   | 錒岁  | 錒岁  | 啊岁  | 啊岁  | 按岁  | 按岁  | 爱岁  | 爱岁  | 哎岁  | 哎岁  | 安岁  | 安岁  | 阿岁  | 阿岁  | 
asun | asunder   | 阿苏那   | 錒孙  | 啊孙  | 啊孙  | asunder   | 按孙  | 按孙  | 爱孙  | 爱孙  | 哎孙  | 哎孙  | 安孙  | 安孙  | 阿孙  | 阿孙  | 
asuo | 阿索   | 暗锁   | 埃索   | 安索   | 啊苏哦  | 錒苏哦  | 錒所  | 錒所  | 啊所  | 啊所  | 按所  | 按所  | 爱所  | 爱所  | 哎所  | 哎所  | 
ata | 阿塔   | 埃托奥   | 爱特爱   | 安踏   | 爱他   | 爱她   | 按他   | 按她   | 奥塔   | 暗塔   | 錒他  | 錒他  | 啊他  | ATA   | 啊他  | 按他  | 
atai | 阿泰   | 阿太   | 安泰   | 安胎   | 奥泰   | 艾泰   | 案台   | 奥太   | 安太   | 錒太  | 錒太  | 啊太  | 啊太  | 按太  | 按太  | 爱太  | 
atan | 哀叹   | 安坦   | 艾坦   | 暗探   | 岸滩   | 暗滩   | 按摊   | 爱他呢   | 錒tan  | 傲头傲脑   | 啊tan  | 按tan  | 爱tan  | 哎tan  | 安tan  | 阿tan  | 
atang | 阿汤   | 阿唐   | 熬汤   | 氨糖   | 安堂   | 安塘   | 庵堂   | 錒糖  | 錒糖  | 啊糖  | 啊糖  | 按糖  | 按糖  | 爱糖  | 爱糖  | 哎糖  | 
atao | 阿涛   | 阿桃   | 安涛   | 爱淘   | 爱涛   | 啊他哦  | 錒他哦  | 錒套  | 錒套  | 啊套  | 啊套  | 按套  | 按套  | 爱淘  | 哎套  | 哎套  | 
ate | 阿特   | 安图恩   | 安徒恩   | ate   | 阿泰尔   | 阿图尔   | 熬头儿   | 艾特   | 奥特   | 安特   | 爱特   | 昂特   | 錒特  | 錒特  | 啊特  | 啊特  | 
atei | 阿忒   | 錒忒  | 錒忒  | 啊忒  | 啊忒  | 按忒  | 按忒  | 爱忒  | 爱忒  | 哎忒  | 哎忒  | 安忒  | 安忒  | 阿忒  | 奥忒  | 奥忒  | 
ateng | 安腾   | 傲腾   | 奥腾   | 安藤   | 阿滕   | 錒疼  | 錒疼  | 啊疼  | 啊疼  | 按疼  | 按疼  | 爱疼  | 爱疼  | 哎疼  | 哎疼  | 安腾  | 
ati | 阿嚏   | 奥体   | 安替   | 挨踢   | 安提   | 錒提  | 錒提  | 啊提  | ATI   | 啊提  | 按提  | 按提  | 爱提  | 爱提  | 哎提  | 哎提  | 
atian | 阿天   | 阿田   | 按天   | 傲天   | 安恬   | 昂天   | 奥田   | 安天   | 安田   | 奥天   | 暗天   | 啊提按  | 按提案   | 啊提按  | 錒提按  | 錒提按  | 
atiao | 艾条   | 安调   | 啊跳   | 啊提奥  | 啊提奥  | 錒提奥  | 錒提奥  | 錒条  | 錒条  | 啊跳  | 按条  | 按条  | 爱条  | 爱条  | 哎条  | 哎条  | 
atie | 阿铁   | 艾贴   | 安帖   | 啊提额  | 啊提额  | 錒提额  | 錒提额  | 錒提额  | 啊提额  | 按踢额  | 按踢额  | 爱踢额  | 爱踢额  | 哎踢额  | 哎踢额  | 安踢额  | 
ating | 阿婷   | 爱听   | 安亭   | 安婷   | 奥亭   | 暗厅   | 艾亭   | 錒听  | 錒听  | 啊听  | 啊听  | 按听  | 按听  | 爱听  | 哎听  | 哎听  | 
atong | 阿瞳   | 安通   | 奥通   | 哀痛   | 癌痛   | 澳通   | 安彤   | 安童   | 哀恸   | 錒同  | 錒同  | 啊同  | 啊同  | 按同  | 按同  | 爱同  | 
atou | 鳌头   | 案头   | 爱投   | 澳头   | 昂头   | 安头   | 錒头  | 錒头  | 啊头  | 啊头  | 按头  | 按头  | 爱投  | 哎头  | 哎头  | 安头  | 
atu | 阿土   | 凹凸   | 按图   | 爱徒   | 安途   | 安土   | 錒图  | 錒图  | 啊图  | 啊图  | 按图  | 爱徒  | 哎图  | 哎图  | 安途  | 阿土  | 
atuan | 爱团   | 安团   | 按图案   | 奥图案   | 啊图按  | 啊图按  | 錒图按  | 錒图按  | 錒图安  | 錒图安  | 啊图安  | 啊图安  | 按图安  | 按图安  | 爱团  | 哎图安  | 
atui | 爱退   | 錒退  | 錒退  | 啊退  | 啊退  | 按退  | 按退  | 爱退  | 哎退  | 哎退  | 安退  | 安退  | 阿退  | 阿退  | 奥退  | 奥退  | 
atun | 安屯   | 奥屯   | 安暾   | 錒tun  | 啊tun  | 按tun  | 爱tun  | 哎tun  | 安tun  | 阿tun  | 奥tun  | 唉tun  | 昂tun  | 熬tun  | 俺tun  | 暗tun  | 
atuo | 阿托   | 奥拓   | 安妥   | 奥托   | 安托   | 安拓   | 啊图哦  | 錒图哦  | 錒拖  | 錒拖  | 啊拖  | 啊拖  | 按拖  | 按拖  | 爱拖  | 爱拖  | 
awa | 阿瓦   | 埃维昂   | 爱喔爱   | 爱娃   | 奥瓦   | 艾娃   | 哎哇   | 錒哇  | 錒哇  | 啊哇  | away   | 啊哇  | 按哇  | 按哇  | 爱娃  | 哎哇  | 
awai | 阿歪   | 安外   | 錒外  | 錒外  | 啊外  | await   | 啊外  | 按外  | 按外  | 爱外  | 爱外  | 哎外  | 哎外  | 安外  | 阿歪  | 奥外  | 
awan | 阿万   | 爱玩   | 按完   | 熬完   | 安完   | 哀婉   | 錒玩  | 錒玩  | 啊玩  | 啊玩  | 按完  | 爱玩  | 哎玩  | 哎玩  | 安完  | 阿万  | 
awang | 阿旺   | 阿王   | 阿汪   | 暗网   | 澳网   | 爱网   | 奥王   | 錒网  | 錒网  | 啊网  | 啊网  | 按网  | 按网  | 爱网  | 哎网  | 哎网  | 
awei | awei   | 阿伟   | 阿威   | (ﾉ"◑ ◑)ﾉ"(｡•́︿•̀｡)   | 阿维   | 阿薇   | 阿魏   | 阿玮   | 安慰   | 安危   | 奥威   | 奥维   | 安委   | 爱卫   | 艾维   | 安伟   | 
awen | 阿文   | 阿雯   | 阿温   | 安稳   | 爱问   | 暗纹   | 艾文   | 奥文   | 安文   | 爱文   | 埃文   | 安雯   | 艾雯   | 錒问  | 錒问  | 啊问  | 
aweng | 艾翁   | 阿翁   | 錒翁  | 錒翁  | 啊翁  | 啊翁  | 按翁  | 按翁  | 爱翁  | 爱翁  | 哎翁  | 哎翁  | 安翁  | 安翁  | 阿翁  | 奥翁  | 
awo | 啊我   | 爱唯欧   | 爱我   | 按我   | 挨我   | 安沃   | 錒我  | 錒我  | 啊我  | awoke   | 按我  | 爱我  | 哎我  | 哎我  | 安沃  | 阿我  | 
awong | 按我那个   | 阿我那个  | 阿我那个  | 錒我那个  | 錒我那个  | 啊我那个  | 啊我那个  | 爱我那个  | 爱我那个  | 按我那个  | 挨我那个  | 挨我那个  | 安沃那个  | 安沃那个  | 錒我弄个  | 錒我弄个  | 
awu | 啊呜   | 阿武   | 阿五   | 嗷呜   | 爱物   | 暗巫   | 爱五   | 傲物   | 錒无  | 錒无  | 啊呜  | 按无  | 按无  | 爱物  | 哎无  | 哎无  | 
axi | 阿西   | 阿喜   | 阿希   | 阿细   | axis   | 爱惜   | 安息   | 艾希   | 安溪   | 奥西   | 爱喜   | 安西   | 昂西   | 艾西   | 暗喜   | 暗系   | 
axia | 阿霞   | 阿夏   | 阿虾   | 爱惜啊   | 按下   | 爱夏   | 鳌虾   | 爱霞   | 暗下   | 安夏   | 安下   | 暗匣   | 錒下  | axial   | 錒下  | 啊下  | 
axian | A线   | 阿贤   | 阿羡   | 阿先   | 阿现   | 凹陷   | 安县   | 暗线   | 爱现   | 岸线   | 安闲   | 氨酰   | 錒先  | 錒先  | 啊先  | 啊先  | 
axiang | 阿香   | 阿翔   | 阿祥   | 阿湘   | 翱翔   | 安详   | 暗香   | 暗箱   | 爱香   | 安乡   | 安享   | 奥翔   | 暗想   | 俺想   | 敖翔   | 安翔   | 
axiao | 阿晓   | 阿消   | 阿小   | 阿肖   | 阿笑   | 阿潇   | 爱笑   | 矮小   | 暗笑   | 爱校   | 安晓   | 挨削   | 爱小   | 啊下哦  | 錒下哦  | 錒小  | 
axie | 安歇   | 爱写   | 奥谢   | 暗血   | 傲血   | 阿谢   | 錒写  | 錒写  | 啊写  | 啊写  | 按写  | 按写  | 爱写  | 哎写  | 哎写  | 安歇  | 
axin | 阿信   | 阿欣   | 阿鑫   | ❥(^_-)   | 阿新   | 阿昕   | 安心   | 爱心   | 爱信   | 澳新   | 安新   | 安鑫   | 熬心   | 安欣   | 奥新   | 艾欣   | 
axing | 阿星   | 阿兴   | A型   | 阿杏   | 安兴   | 奥星   | 矮星   | 暗星   | 安行   | 爱行   | 昂星   | 安星   | 澳星   | 熬兴   | 拗性   | 敖兴   | 
axiong | 阿雄   | 阿兄   | 挨熊   | 錒熊  | 錒熊  | 啊熊  | 啊熊  | 按熊  | 按熊  | 爱熊  | 爱熊  | 哎熊  | 哎熊  | 安熊  | 安熊  | 阿雄  | 
axiu | 阿秀   | 安秀   | 爱秀   | 氨溴   | 奥修   | 錒修  | 錒修  | 啊修  | 啊修  | 按修  | 按修  | 爱秀  | 哎修  | 哎修  | 安秀  | 阿秀  | 
axu | 阿旭   | 阿虚   | 阿絮   | 按需   | 安旭   | 敖胥   | 艾许   | 錒许  | 錒许  | 啊许  | 啊许  | 按需  | 爱许  | 爱许  | 哎许  | 哎许  | 
axuan | 阿轩   | 安选   | 敖宣   | 啊许按  | 啊许按  | 錒许按  | 錒许按  | 錒选  | 錒选  | 啊选  | 啊选  | 按选  | 按选  | 爱选  | 爱选  | 哎选  | 
axue | 阿雪   | 傲雪   | 爱学   | 暗血   | 傲血   | 艾雪   | 安雪   | 澳雪   | 爱雪   | 矮靴   | 敖雪   | 啊许额  | 啊许额  | 錒许额  | 錒许额  | 錒学  | 
axun | 挨训   | 安迅   | 安讯   | 安勋   | 錒寻  | 錒寻  | 啊寻  | 啊寻  | 按寻  | 按寻  | 爱寻  | 爱寻  | 哎寻  | 哎寻  | 安迅  | 阿寻  | 
aya | 啊呀   | 熬一熬   | 阿雅   | 吖吖   | 按一按   | 爱乐爱   | 阿亚   | ayawawa   | 哎呀   | 按压   | 奥雅   | 爱呀   | 安雅   | 爱牙   | 奥亚   | 暗鸦   | 
ayan | 阿燕   | 阿炎   | 阿颜   | 碍眼   | 铵盐   | 爱眼   | 安颜   | 安燕   | 安岩   | 爱演   | 哀艳   | 按验   | 案验   | 暗演   | 暗炎   | 錒眼  | 
ayang | 阿阳   | 阿杨   | 阿泱   | 阿扬   | 安阳   | 昂扬   | 澳洋   | 按样   | 艾洋   | 安洋   | 艾阳   | 爱漾   | 錒样  | 錒样  | 啊样  | 啊样  | 
ayao | 阿瑶   | 阿耀   | 阿尧   | 阿垚   | 爱要   | 熬药   | 俺要   | 挨咬   | 錒要  | 錒要  | 啊要  | 啊要  | 按要  | 按要  | 爱要  | 哎要  | 
aye | aye   | 阿爷   | 阿耶   | 阿夜   | 阿也   | 安艺恩   | 熬夜   | 暗夜   | 艾叶   | 俺也   | 安业   | 俺爷   | 奥耶   | 爱液   | 安叶   | 庵野   | 
ayi | 阿姨   | 阿依   | 阿怡   | 阿一   | 阿义   | 阿易   | 阿伊   | 安逸   | 爱意   | 奥义   | 安义   | 安医   | 俺姨   | 安怡   | 昂一   | 暗裔   | 
ayin | 阿银   | 阿音   | 艾因   | 安隐   | 爱音   | 傲因   | 暗瘾   | 凹音   | 錒因  | 錒因  | 啊因  | 啊因  | 按因  | 按因  | 爱音  | 哎因  | 
aying | 阿英   | 阿莹   | 阿颖   | 阿影   | 暗影   | 爱婴   | 安营   | 爱英   | 安盈   | 熬鹰   | 奥英   | 安颖   | 安莹   | 錒赢  | 錒赢  | 啊赢  | 
ayo | 啊哟   | 哎哟   | 唉哟   | 哎唷   | 錒yo  | 啊yo  | 按yo  | 爱yo  | 哎yo  | 安yo  | 阿yo  | 奥yo  | 唉yo  | 昂yo  | 熬yo  | 俺yo  | 
ayong | 阿勇   | 阿永   | 爱用   | 安永   | 暗涌   | 安勇   | 錒用  | 錒用  | 啊用  | 啊用  | 按用  | 按用  | 爱用  | 哎用  | 哎用  | 安永  | 
ayou | 阿尤   | 阿有   | 啊呦   | (ｷ｀ﾟДﾟ´)!!   | 阿友   | 阿油   | 阿游   | 哎呦   | 遨游   | 矮油   | 俺有   | 爱幼   | 澳优   | 爱有   | 傲游   | 安佑   | 
ayu | 阿玉   | 阿宇   | 阿语   | 阿雨   | 阿臾   | 阿谀   | 碍于   | 暗语   | 安于   | 爱与   | 暗喻   | 奥宇   | 按语   | 安宇   | 爱玉   | 爱欲   | 
ayuan | 阿园   | 阿元   | 奥园   | 安远   | 澳元   | 哀怨   | 安源   | 爱媛   | 案源   | 昂元   | 安园   | 奥源   | 安苑   | 安元   | 爱园   | 安媛   | 
ayue | 阿月   | 阿越   | 阿悦   | 按月   | 暗月   | 安岳   | 爱乐   | 哀乐   | 傲月   | 安悦   | 爱阅   | 錒月  | 錒月  | 啊余额  | 錒月  | 啊余额  | 
ayun | 阿云   | 奥运   | 爱云   | 安云   | 安运   | 傲云   | 錒晕  | 錒晕  | 啊晕  | 啊晕  | 按晕  | 按晕  | 爱云  | 哎晕  | 哎晕  | 安云  | 
aza | 腌臜   | 案中案   | 挨拶   | 錒咋  | 錒咋  | azalea   | 啊咋  | 啊咋  | 按咋  | 按咋  | 爱咋  | 爱咋  | 哎咋  | 哎咋  | 安咋  | 安咋  | 
azai | 按在   | 爱在   | 安在   | 安仔   | 挨宰   | 俺在   | 矮仔   | 哀哉   | 阿在   | 錒在  | 錒在  | 啊在  | 啊在  | 按在  | 爱在  | 哎在  | 
azan | 阿赞   | 挨拶   | 爱赞   | 錒咱  | 錒咱  | 啊咱  | 啊咱  | 按咱  | 按咱  | 爱赞  | 哎咱  | 哎咱  | 安咱  | 安咱  | 阿咱  | 阿咱  | 
azang | 肮脏   | 安葬   | 阿脏   | 錒脏  | 錒脏  | 啊脏  | 啊脏  | 按脏  | 按脏  | 爱脏  | 爱脏  | 哎脏  | 哎脏  | 安葬  | 阿脏  | 奥脏  | 
azao | 懊糟   | 凹糟   | 阿早   | 啊咋哦  | 錒咋哦  | 錒早  | 錒早  | 啊早  | 啊早  | 按早  | 按早  | 爱早  | 爱早  | 哎早  | 哎早  | 安早  | 
aze | 阿泽   | 阿扎尔   | 阿兹尔   | 艾泽尔   | 安泽   | 艾泽   | 奥泽   | 錒则  | 錒则  | Azerbaijan   | 啊则  | 啊则  | 按则  | 按则  | 爱则  | 爱则  | 
azei | 阿贼   | 錒贼  | 錒贼  | 啊贼  | 啊贼  | 按贼  | 按贼  | 爱贼  | 爱贼  | 哎贼  | 哎贼  | 安贼  | 安贼  | 阿贼  | 奥贼  | 奥贼  | 
azen | 爱怎   | 錒怎  | 錒怎  | 啊怎  | 啊怎  | 按怎  | 按怎  | 爱怎  | 哎怎  | 哎怎  | 安怎  | 安怎  | 阿怎  | 阿怎  | 奥怎  | 奥怎  | 
azeng | 爱憎   | 安增   | 錒曾  | 錒曾  | 啊曾  | 啊曾  | 按曾  | 按曾  | 爱憎  | 哎曾  | 哎曾  | 安曾  | 安曾  | 阿曾  | 阿曾  | 奥曾  | 
azha | 阿扎   | 安札   | 錒炸  | 錒炸  | 啊炸  | 啊炸  | 按炸  | 按炸  | 爱炸  | 爱炸  | 哎炸  | 哎炸  | 安札  | 阿扎  | 奥炸  | 奥炸  | 
azhai | 阿宅   | 安寨   | 矮寨   | 暗宅   | 錒宅  | 錒宅  | 啊宅  | 啊宅  | 按宅  | 按宅  | 爱宅  | 爱宅  | 哎宅  | 哎宅  | 安寨  | 阿宅  | 
azhan | A站   | 暗战   | 爱占   | 鏖战   | 奥展   | 氨站   | 錒站  | 錒站  | 啊站  | 啊站  | 按站  | 按站  | 爱占  | 哎站  | 哎站  | 安站  | 
azhang | 阿张   | 阿长   | 暗账   | 暗帐   | 錒张  | 錒张  | 啊张  | 啊张  | 按张  | 按张  | 爱张  | 爱张  | 哎张  | 哎张  | 安张  | 安张  | 
azhao | 按照   | 爱找   | 敖钊   | 安钊   | 啊炸哦  | 錒炸哦  | 錒找  | 錒找  | 啊找  | 啊找  | 按照  | 爱找  | 哎找  | 哎找  | 安找  | 安找  | 
azhe | 阿哲   | 挨着   | 按着   | 爱着   | 熬着   | 俺这   | 碍着   | 暗着   | 安哲   | 艾哲   | 錒这  | 錒这  | 啊这  | 啊这  | 按着  | 爱着  | 
azhei | 阿这   | 錒这  | 錒这  | 啊这  | 啊这  | 按这  | 按这  | 爱这  | 爱这  | 哎这  | 哎这  | 安这  | 安这  | 阿这  | 奥这  | 奥这  | 
azhen | 阿珍   | 阿真   | 阿贞   | 阿振   | 安贞   | 爱珍   | 安镇   | 安枕   | 錒真  | 錒真  | 啊真  | 啊真  | 按真  | 按真  | 爱珍  | 哎真  | 
azheng | 阿正   | 阿政   | A证   | 癌症   | 安正   | 挨整   | 奥正   | 安证   | 錒正  | 錒正  | 啊正  | 啊正  | 按正  | 按正  | 爱正  | 爱正  | 
azhi | 阿志   | 阿智   | 阿织   | 安置   | 熬制   | 爱之   | 安质   | 暗指   | 安之   | 昂志   | 安智   | 按置   | 爱知   | 案值   | 安知   | 安职   | 
azhong | 阿忠   | 阿钟   | 暗中   | 爱中   | 奥众   | 安中   | 爱众   | 爱重   | 錒中  | 錒中  | 啊中  | 啊中  | 按中  | 按中  | 爱中  | 哎中  | 
azhou | 阿周   | 阿洲   | 澳洲   | 安州   | 熬粥   | 爱周   | 錒周  | 錒周  | 啊周  | 啊周  | 按周  | 按周  | 爱周  | 哎周  | 哎周  | 安州  | 
azhu | 阿朱   | 阿猪   | 阿珠   | 阿柱   | 阿竹   | 按住   | 熬煮   | 暗柱   | 艾柱   | 案主   | 爱珠   | 艾朱   | 錒住  | 錒住  | 啊住  | 啊住  | 
azhua | 爱抓   | 按住啊   | 啊住啊  | 錒住啊  | 錒抓  | 錒抓  | 啊抓  | 啊抓  | 按住啊  | 爱抓  | 哎抓  | 哎抓  | 安抓  | 安抓  | 阿抓  | 阿抓  | 
azhuai | 啊住爱   | 啊住爱  | 錒住爱  | 錒住爱  | 錒驻爱  | 錒驻爱  | 啊驻爱  | 啊驻爱  | 按驻爱  | 按驻爱  | 爱驻爱  | 爱驻爱  | 哎驻爱  | 哎驻爱  | 安驻爱  | 安驻爱  | 
azhuan | 暗转   | 啊转   | 啊住按  | 啊住按  | 錒住按  | 錒住按  | 錒转  | 錒转  | 啊转  | 按转  | 按转  | 爱转  | 爱转  | 哎转  | 哎转  | 安转  | 
azhuang | 阿庄   | 安装   | 暗装   | 爱装   | 安庄   | 俺庄   | 矮桩   | 啊住昂  | 啊住昂  | 錒住昂  | 錒住昂  | 錒猪昂  | 錒猪昂  | 啊猪昂  | 啊猪昂  | 按猪昂  | 
azhui | 爱追   | 錒追  | 錒追  | 啊追  | 啊追  | 按追  | 按追  | 爱追  | 哎追  | 哎追  | 安追  | 安追  | 阿追  | 阿追  | 奥追  | 奥追  | 
azhun | 安准   | 啊住你   | 阿准   | 錒准  | 錒准  | 啊准  | 啊准  | 按准  | 按准  | 爱准  | 爱准  | 哎准  | 哎准  | 安准  | 阿准  | 奥准  | 
azhuo | 安卓   | 艾卓   | 阿卓   | 啊住哦  | 錒住哦  | 錒桌  | 錒桌  | 啊桌  | 啊桌  | 按桌  | 按桌  | 爱桌  | 爱桌  | 哎桌  | 哎桌  | 安卓  | 
azi | 阿紫   | 阿子   | 阿姊   | 案子   | 矮子   | 艾滋   | 袄子   | 暗自   | 安子   | 爱子   | 暗紫   | 奥兹   | 鞍子   | 矮仔   | 鏊子   | 哀子   | 
azong | 阿棕   | 安总   | 暗棕   | 案宗   | 錒总  | 錒总  | 啊总  | 啊总  | 按总  | 按总  | 爱总  | 爱总  | 哎总  | 哎总  | 安总  | 阿总  | 
azou | 挨揍   | 俺走   | 爱走   | 安邹   | 錒走  | 錒走  | 啊走  | 啊走  | 按走  | 按走  | 爱走  | 哎走  | 哎走  | 安走  | 安走  | 阿走  | 
azu | A组   | 阿祖   | 安祖   | 錒组  | 錒组  | azure   | 啊组  | 啊组  | 按组  | 按组  | 爱组  | 爱组  | 哎组  | 哎组  | 安祖  | 阿祖  | 
azuan | 安钻   | 爱钻   | 啊组按  | 啊组按  | 錒组按  | 錒组按  | 錒阻按  | 錒阻按  | 啊阻按  | 啊阻按  | 按阻按  | 按阻按  | 爱阻按  | 爱阻按  | 哎阻按  | 哎阻按  | 
azui | 按最   | 錒最  | 錒最  | 啊最  | 啊最  | 按最  | 爱最  | 爱最  | 哎最  | 哎最  | 安最  | 安最  | 阿最  | 阿最  | 奥最  | 奥最  | 
azun | 爱尊   | 安遵   | 錒尊  | 錒尊  | 啊尊  | 啊尊  | 按尊  | 按尊  | 爱尊  | 哎尊  | 哎尊  | 安尊  | 安尊  | 阿尊  | 阿尊  | 奥尊  | 
azuo | A座   | 阿左   | 爱做   | 鞍座   | 啊组哦  | 錒组哦  | 錒做  | 錒做  | 啊做  | 啊做  | 按做  | 按做  | 爱做  | 哎做  | 哎做  | 安做  | 
aia | 爱啊   | 爱爱   | 哎哎   | 矮矮   | 唉唉   | 艾艾   | 艾奥   | 皑皑   | 挨挨   | 哀哀   | 蔼蔼   | 爱啊  | 哎啊  | 唉啊  | AIA   | 矮啊  | 
aiai | 爱爱   | 哎哎   | 矮矮   | 唉唉   | 艾艾   | 皑皑   | 挨挨   | 哀哀   | 蔼蔼   | 爱爱  | 哎哎  | AI爱  | 唉唉  | 矮矮  | 挨挨  | 艾艾  | 
aian | 爱安   | 爱安  | 哎按  | 哎按  | AI按  | 唉按  | 唉按  | 矮按  | 矮按  | 挨按  | 挨按  | 艾按  | 艾按  | 哀按  | 哀按  | 癌按  | 
aiang | 艾昂   | 爱昂  | 爱昂  | 哎昂  | 哎昂  | AI昂  | 唉昂  | 唉昂  | 矮昂  | 矮昂  | 挨昂  | 挨昂  | 艾昂  | 哀昂  | 哀昂  | 癌昂  | 
aiao | 艾奥   | 爱奥  | 爱奥  | 哎奥  | 哎奥  | AI奥  | AIA哦  | 唉奥  | 唉奥  | 矮奥  | 矮奥  | 挨奥  | 挨奥  | 艾奥  | 哀奥  | 哀奥  | 
aiba | 爱吧   | 爱拔   | 爱吧  | 哎吧  | 哎吧  | 唉吧  | 唉吧  | 矮吧  | 矮吧  | 挨吧  | 挨吧  | 艾吧  | 艾吧  | AI吧  | 哀吧  | 哀吧  | 
aibai | 爱白   | 爱白  | 哎白  | 哎白  | 唉白  | 唉白  | 矮白  | 矮白  | 挨白  | 挨白  | 艾白  | 艾白  | AI白  | 哀白  | 哀白  | 癌白  | 
aiban | 艾粄   | 呆板   | 爱班  | 爱班  | 哎班  | 哎班  | 唉班  | 唉班  | 矮班  | 矮班  | 挨班  | 挨班  | 艾粄  | AI班  | 哀班  | 哀班  | 
aibang | 爱帮   | 爱邦   | 爱bang  | 哎bang  | 唉bang  | 矮bang  | 挨bang  | 艾bang  | AIbang  | 哀bang  | 癌bang  | 碍bang  | 埃bang  | 嗳bang  | 捱bang  | 暧bang  | 
aibao | 爱宝   | 艾宝   | 哀吧哦  | 艾吧哦  | 挨吧哦  | 矮吧哦  | 唉吧哦  | 哎吧哦  | 爱宝  | 哎包  | 哎包  | AI包  | 唉包  | 唉包  | 矮包  | 矮包  | 
aibei | 爱贝   | 艾北   | 爱贝  | 哎被  | 哎被  | AI被  | 唉被  | 唉被  | 矮被  | 矮被  | 挨被  | 挨被  | 艾被  | 艾被  | 哀被  | 哀被  | 
aiben | 艾本   | 爱本  | 爱本  | 哎本  | 哎本  | AI本  | 唉本  | 唉本  | 矮本  | 矮本  | 挨本  | 挨本  | 艾本  | 哀本  | 哀本  | 癌本  | 
aibeng | 爱蹦   | 爱beng  | 哎beng  | AIbeng  | 唉beng  | 矮beng  | 挨beng  | 艾beng  | 哀beng  | 癌beng  | 碍beng  | 埃beng  | 嗳beng  | 捱beng  | 暧beng  | 愛beng  | 
aibi | 艾比   | 爱彼   | 埃比   | 爱彼  | 哎比  | 哎比  | 唉比  | 唉比  | 矮比  | 矮比  | 挨比  | 挨比  | 艾比  | AI比  | 哀比  | 哀比  | 
aibian | 癌变   | 挨边   | 哀比按  | 爱彼岸   | 哀比按  | 挨比按  | 挨比按  | 矮比按  | 矮比按  | 唉比按  | 唉比按  | 哎比按  | 哎比按  | 爱彼岸  | 哎变  | 哎变  | 
aibiang | 爱碧昂   | 哀比昂  | 哀比昂  | 挨比昂  | 挨比昂  | 矮比昂  | 矮比昂  | 唉比昂  | 唉比昂  | 哎比昂  | 哎比昂  | 艾比昂  | 艾比昂  | 爱彼昂  | 爱彼昂  | 埃比昂  | 
aibiao | 爱表   | 哀比奥  | 哀比奥  | 挨比奥  | 挨比奥  | 矮比奥  | 挨比奥  | 唉比奥  | 唉比奥  | 哎比奥  | 哎比奥  | 爱表  | 哎表  | 哎表  | AI表  | 唉表  | 
aibie | 爱别   | 哀比额  | 挨比额  | 哀比额  | 矮比额  | 挨比额  | 哀比额  | 唉比额  | 唉比额  | 哎比额  | 哎比额  | 爱别  | 哎逼额  | 哎逼额  | AI逼额  | 唉逼额  | 
aibin | 爱斌   | 爱bin  | 哎bin  | AIbin  | 唉bin  | 矮bin  | 挨bin  | 艾bin  | 哀bin  | 癌bin  | 碍bin  | 埃bin  | 嗳bin  | 捱bin  | 暧bin  | 愛bin  | 
aibing | 癌病   | 艾饼   | 爱兵  | 爱兵  | 哎病  | 哎病  | AI病  | 唉病  | 唉病  | 矮病  | 矮病  | 挨病  | 挨病  | 艾饼  | 哀病  | 哀病  | 
aibo | 爱博   | 艾博   | 爱博  | 哎波  | 哎波  | AI波  | 唉波  | 唉波  | 矮波  | 矮波  | 挨波  | 挨波  | 艾博  | 哀波  | 哀波  | 癌波  | 
aibu | 爱步   | 爱不   | 爱不  | 哎不  | 哎不  | 唉不  | 唉不  | 矮不  | 矮不  | 挨不  | 挨不  | 艾不  | 艾不  | AI不  | 哀不  | 哀不  | 
aica | 爱擦   | 爱擦  | 哎擦  | 哎擦  | 唉擦  | 唉擦  | 矮擦  | 矮擦  | 挨擦  | 挨擦  | 艾擦  | 艾擦  | AI擦  | 哀擦  | 哀擦  | 癌擦  | 
aicai | 爱财   | 爱才   | 爱才  | 哎才  | 哎才  | 唉才  | 唉才  | 矮才  | 矮才  | 挨才  | 挨才  | 艾才  | 艾才  | AI才  | 哀才  | 哀才  | 
aican | 艾灿   | 爱惨  | 爱惨  | 哎惨  | 哎惨  | 唉惨  | 唉惨  | 矮惨  | 矮惨  | 挨惨  | 挨惨  | 艾灿  | AI惨  | 哀惨  | 哀惨  | 癌惨  | 
aicang | 爱藏   | 爱藏  | 哎藏  | 哎藏  | AI藏  | 唉藏  | 唉藏  | 矮藏  | 矮藏  | 挨藏  | 挨藏  | 艾藏  | 艾藏  | 哀藏  | 哀藏  | 癌藏  | 
aicao | 艾草   | 癌擦哦  | 艾擦哦  | 哀擦哦  | 矮擦哦  | 挨擦哦  | 爱擦哦  | 唉擦哦  | 哎擦哦  | 爱草  | 爱草  | 哎草  | 哎草  | AI草  | 唉草  | 唉草  | 
aice | 艾策   | 爱测  | 爱测  | 哎测  | 哎测  | AI测  | 唉测  | 唉测  | 矮测  | 矮测  | 挨测  | 挨测  | 艾策  | 哀测  | 哀测  | 癌测  | 
aicei | 爱岑   | 癌测i  | 爱侧i  | 哀测i  | 挨测i  | 矮测i  | 唉测i  | 哎测i  | 爱测i  | 艾策i  | 爱ceiling  | 哎ceiling  | AIceiling  | 唉ceiling  | 矮ceiling  | 挨ceiling  | 
aicen | 爱岑   | 爱cen  | 哎cen  | 唉cen  | 矮cen  | 挨cen  | 艾cen  | AIcen  | 哀cen  | 癌cen  | 碍cen  | 埃cen  | 嗳cen  | 捱cen  | 暧cen  | 愛cen  | 
aiceng | 爱层   | 爱层  | 哎层  | 哎层  | 唉层  | 唉层  | 矮层  | 矮层  | 挨层  | 挨层  | 艾层  | 艾层  | AI层  | 哀层  | 哀层  | 癌层  | 
aicha | 爱茶   | 爱茶  | 哎差  | 哎差  | AI差  | 唉差  | 唉差  | 矮差  | 矮差  | 挨差  | 挨差  | 艾差  | 艾差  | 哀差  | 哀差  | 癌差  | 
aichai | 爱拆   | 爱拆  | 哎拆  | 哎拆  | AI拆  | 唉拆  | 唉拆  | 矮拆  | 矮拆  | 挨拆  | 挨拆  | 艾拆  | 艾拆  | 哀拆  | 哀拆  | 癌拆  | 
aichan | 艾婵   | 爱产  | 爱产  | 哎产  | 哎产  | 唉产  | 唉产  | 矮产  | 矮产  | 挨产  | 挨产  | 艾婵  | AI产  | 哀产  | 哀产  | 癌产  | 
aichang | 爱唱   | 艾畅   | 爱唱  | 哎长  | 哎长  | 唉长  | 唉长  | 矮长  | 矮长  | 挨长  | 挨长  | 艾畅  | AI长  | 哀长  | 哀长  | 癌长  | 
aichao | 挨吵   | 爱巢   | 癌差哦  | 艾差哦  | 哀差哦  | 矮差哦  | 挨差哦  | 爱茶哦  | 唉差哦  | 哎差哦  | 爱巢  | 哎超  | 哎超  | 唉超  | 唉超  | 矮超  | 
aiche | 爱车   | 爱车  | 哎车  | 哎车  | 唉车  | 唉车  | 矮车  | 矮车  | 挨车  | 挨车  | 艾车  | 艾车  | AI车  | 哀车  | 哀车  | 癌车  | 
aichen | 艾辰   | 爱陈  | 爱陈  | 哎陈  | 哎陈  | AI陈  | 唉陈  | 唉陈  | 矮陈  | 矮陈  | 挨陈  | 挨陈  | 艾辰  | 哀陈  | 哀陈  | 癌陈  | 
aicheng | 爱称   | 爱城   | 爱成   | 爱称  | 哎成  | 哎成  | AI成  | 唉成  | 唉成  | 矮成  | 矮成  | 挨成  | 挨成  | 艾成  | 艾成  | 哀成  | 
aichi | 爱吃   | 爱吃  | 哎吃  | 哎吃  | AI吃  | 唉吃  | 唉吃  | 矮吃  | 矮吃  | 挨吃  | 挨吃  | 艾吃  | 艾吃  | 哀吃  | 哀吃  | 癌吃  | 
aichong | 爱宠   | 爱充   | 爱宠  | 哎冲  | 哎冲  | AI冲  | 唉冲  | 唉冲  | 矮冲  | 矮冲  | 挨冲  | 挨冲  | 艾冲  | 艾冲  | 哀冲  | 哀冲  | 
aichou | 哀愁   | 挨抽   | 爱抽  | 爱抽  | 哎抽  | 哎抽  | 唉抽  | 唉抽  | 矮抽  | 矮抽  | 挨抽  | 艾抽  | 艾抽  | AI抽  | 哀愁  | 癌抽  | 
aichu | 爱出   | 爱出  | 哎出  | 哎出  | 唉出  | 唉出  | 矮出  | 矮出  | 挨出  | 挨出  | 艾出  | 艾出  | AI出  | 哀出  | 哀出  | 癌出  | 
aichua | 爱穿   | 癌出啊   | 哀出啊  | 艾出啊  | 挨出啊  | 矮出啊  | 唉出啊  | 哎出啊  | 爱歘  | 爱歘  | 哎歘  | 哎歘  | 唉歘  | 唉歘  | 矮歘  | 矮歘  | 
aichuai | 爱处爱   | 癌出爱  | 癌出爱  | 哀出爱  | 哀出爱  | 艾出爱  | 艾出爱  | 挨出爱  | 挨出爱  | 矮出爱  | 矮出爱  | 唉出爱  | 唉出爱  | 哎出爱  | 哎出爱  | 爱雏爱  | 
aichuan | 爱穿   | 癌出按  | 癌出按  | 哀出按  | 哀出按  | 艾出按  | 艾出按  | 矮出按  | 挨出按  | 挨出按  | 矮出按  | 唉出按  | 唉出按  | 哎出按  | 哎出按  | 爱穿  | 
aichuang | 爱创   | 癌出昂  | 癌出昂  | 艾出昂  | 哀出昂  | 艾出昂  | 哀出昂  | 矮出昂  | 矮出昂  | 挨出昂  | 矮出昂  | 唉出昂  | 唉出昂  | 哎出昂  | 哎出昂  | 爱创  | 
aichui | 爱吹   | 爱吹  | 哎吹  | 哎吹  | AI吹  | 唉吹  | 唉吹  | 矮吹  | 矮吹  | 挨吹  | 挨吹  | 艾吹  | 艾吹  | 哀吹  | 哀吹  | 癌吹  | 
aichun | 爱春   | 爱春  | 哎春  | 哎春  | AI春  | 唉春  | 唉春  | 矮春  | 矮春  | 挨春  | 挨春  | 艾春  | 艾春  | 哀春  | 哀春  | 癌春  | 
aichuo | 矮戳   | 癌出哦  | 哀出哦  | 艾出哦  | 矮出哦  | 挨出哦  | 唉出哦  | 哎出哦  | 爱戳  | 爱戳  | 哎戳  | 哎戳  | 唉戳  | 唉戳  | 矮戳  | 挨戳  | 
aici | 挨次   | 艾糍   | 哀辞   | 爱次  | 爱次  | 哎次  | 哎次  | 唉次  | 唉次  | 矮次  | 矮次  | 挨次  | 艾糍  | AI次  | 哀辞  | 癌次  | 
aicong | 爱从   | 爱从  | 哎从  | 哎从  | 唉从  | 唉从  | 矮从  | 矮从  | 挨从  | 挨从  | 艾从  | 艾从  | AI从  | 哀从  | 哀从  | 癌从  | 
aicou | 爱凑   | 爱凑  | 哎凑  | 哎凑  | 唉凑  | 唉凑  | 矮凑  | 矮凑  | 挨凑  | 挨凑  | 艾凑  | 艾凑  | AI凑  | 哀凑  | 哀凑  | 癌凑  | 
aicu | 爱粗   | 爱粗  | 哎粗  | 哎粗  | AI粗  | 唉粗  | 唉粗  | 矮粗  | 矮粗  | 挨粗  | 挨粗  | 艾粗  | 艾粗  | 哀粗  | 哀粗  | 癌粗  | 
aicuan | 爱醋按   | 癌粗按  | 癌粗按  | 哀粗按  | 哀粗按  | 艾粗按  | 艾粗按  | 挨粗按  | 挨粗按  | 矮粗按  | 矮粗按  | 唉粗按  | 唉粗按  | 哎粗按  | 哎粗按  | 爱粗按  | 
aicui | 爱翠   | 爱翠  | 哎催  | 哎催  | AI催  | 唉催  | 唉催  | 矮催  | 矮催  | 挨催  | 挨催  | 艾催  | 艾催  | 哀催  | 哀催  | 癌催  | 
aicun | 爱村   | 爱村  | 哎存  | 哎存  | AI存  | 唉存  | 唉存  | 矮存  | 矮存  | 挨存  | 挨存  | 艾存  | 艾存  | 哀存  | 哀存  | 癌存  | 
aicuo | 爱错   | 癌粗哦  | 哀粗哦  | 艾粗哦  | 矮粗哦  | 挨粗哦  | 唉粗哦  | 哎粗哦  | 爱粗哦  | 爱错  | 哎错  | 哎错  | 唉错  | 唉错  | 矮错  | 矮错  | 
aida | 挨打   | 爱打   | 艾达   | 爱达   | Aidan   | 爱打  | 哎大  | 哎大  | 唉大  | 唉大  | 矮大  | 矮大  | 挨打  | 艾达  | AI大  | 哀大  | 
aidai | 爱戴   | 叆叇   | 爱戴  | 哎带  | 哎带  | 唉带  | 唉带  | 矮带  | 矮带  | 挨带  | 挨带  | 艾带  | 艾带  | AI带  | 哀带  | 哀带  | 
aidan | 艾丹   | 爱但  | 爱但  | 哎但  | Aidan   | 哎但  | AI但  | 唉但  | 唉但  | 矮但  | 矮但  | 挨但  | 挨但  | 艾丹  | 哀但  | 哀但  | 
aidang | 爱党   | 爱宕   | 爱党  | 哎当  | 哎当  | AI当  | 唉当  | 唉当  | 矮当  | 矮当  | 挨当  | 挨当  | 艾当  | 艾当  | 哀当  | 哀当  | 
aidao | 挨到   | 爱到   | 哀悼   | 挨刀   | 哀大哦  | 矮大哦  | 唉大哦  | 哎大哦  | 爱到  | 哎到  | 哎到  | 唉到  | 唉到  | 矮到  | 矮到  | 挨打哦  | 
aide | aide   | 爱的   | 爱得   | 矮的   | 艾德   | 爱德   | 挨得   | 埃德   | 爱的  | 哎的  | 哎的  | 唉的  | 唉的  | 矮的  | 挨得  | 艾德  | 
aidei | 爱得   | 爱得  | 哎得  | 哎得  | AI得  | 唉得  | 唉得  | 矮得  | 矮得  | 挨得  | 挨得  | 艾得  | 艾得  | 哀得  | 哀得  | 癌得  | 
aiden | 矮凳   | 爱的呢   | 爱的那   | 哎den  | AIden  | 唉den  | 矮den  | 挨den  | 艾den  | 哀den  | 癌den  | 碍den  | 埃den  | 嗳den  | 捱den  | 暧den  | 
aideng | 矮凳   | 艾登   | 爱等  | 爱等  | 哎等  | 哎等  | AI等  | 唉等  | 唉等  | 矮凳  | 挨等  | 挨等  | 艾登  | 哀等  | 哀等  | 癌等  | 
aidi | 艾迪   | 爱迪   | 爱地   | 埃迪   | 爱滴   | 爱帝   | 爱地  | 哎地  | 哎地  | AI地  | 唉地  | 唉地  | 矮地  | 矮地  | 挨地  | 挨地  | 
aidia | 艾迪啊   | 挨地啊  | 矮地啊  | 唉地啊  | 哎地啊  | 爱嗲  | 爱嗲  | 哎嗲  | 哎嗲  | 唉嗲  | 唉嗲  | 矮嗲  | 矮嗲  | 挨嗲  | 挨嗲  | 艾嗲  | 
aidian | 矮点   | 爱点   | 挨地按  | 艾迪安   | 挨地按  | 矮地按  | 矮地按  | 唉地按  | 唉地按  | 哎地按  | 哎地按  | 爱点  | 哎点  | 哎点  | 唉点  | 唉点  | 
aidiao | 爱掉   | 艾嗲哦  | 挨嗲哦  | 矮嗲哦  | 唉嗲哦  | 哎嗲哦  | 爱嗲哦  | 艾迪啊哦  | 挨地奥  | 挨地奥  | 矮地奥  | 矮地奥  | 唉地奥  | 唉地奥  | 哎地奥  | 哎地奥  | 
aidie | 艾蝶   | 挨地额  | 矮地额  | 挨地额  | 矮地额  | 唉地额  | 唉地额  | 哎地额  | 哎地额  | 爱爹  | 爱爹  | 哎爹  | 哎爹  | 唉爹  | 唉爹  | 矮爹  | 
aidin | 爱定   | 矮地你  | 矮地你  | 挨地你  | 挨地你  | 唉地你  | 唉地你  | 哎地你  | 哎地你  | 艾迪你  | 艾迪你  | 爱迪你  | 爱迪你  | 爱地你  | 爱地你  | 埃迪你  | 
aiding | 爱定   | 爱定  | 哎定  | 哎定  | AI定  | 唉定  | 唉定  | 矮定  | 矮定  | 挨定  | 挨定  | 艾定  | 艾定  | 哀定  | 哀定  | 癌定  | 
aidiu | 爱丢   | 爱丢  | 哎丢  | 哎丢  | AI丢  | 唉丢  | 唉丢  | 矮丢  | 矮丢  | 挨丢  | 挨丢  | 艾丢  | 艾丢  | 哀丢  | 哀丢  | 癌丢  | 
aidong | 挨冻   | 爱动   | 爱东   | 艾东   | 哀恸   | 爱动  | 哎懂  | 哎懂  | AI懂  | 唉懂  | 唉懂  | 矮懂  | 矮懂  | 挨冻  | 艾东  | 哀懂  | 
aidou | 爱豆   | 爱豆  | 哎都  | 哎都  | AI都  | 唉都  | 唉都  | 矮都  | 矮都  | 挨都  | 挨都  | 艾都  | 艾都  | 哀都  | 哀都  | 癌都  | 
aidu | 爱都   | 爱度   | 爱读   | 爱都  | 哎度  | 哎度  | AI度  | 唉度  | 唉度  | 矮度  | 矮度  | 挨度  | 挨度  | 艾度  | 艾度  | 哀度  | 
aiduan | 爱读按   | 哀度按  | 哀度按  | 艾度按  | 艾度按  | 挨度按  | 挨度按  | 矮度按  | 矮度按  | 唉度按  | 唉度按  | 哎度按  | 哎度按  | 爱赌按  | 爱赌按  | 哎赌按  | 
aidui | 爱对   | 哎对   | 爱对  | 哎对  | AI对  | 唉对  | 唉对  | 矮对  | 矮对  | 挨对  | 挨对  | 艾对  | 艾对  | 哀对  | 哀对  | 癌对  | 
aidun | 艾顿   | 矮墩   | 爱顿  | 爱顿  | 哎顿  | 哎顿  | 唉顿  | 唉顿  | 矮墩  | 挨顿  | 挨顿  | 艾顿  | AI顿  | 哀顿  | 哀顿  | 癌顿  | 
aiduo | 爱多   | 哀度哦  | 艾度哦  | 矮度哦  | 挨度哦  | 唉度哦  | 哎度哦  | 爱duo  | 哎duo  | 唉duo  | 矮duo  | 挨duo  | 艾duo  | AIduo  | 哀duo  | 癌duo  | 
aie | 挨饿   | 艾尔   | 爱尔   | 埃尔   | 爱儿   | 艾儿   | 爱耳   | 爱额  | 爱额  | 哎额  | 哎额  | 唉额  | 唉额  | 矮额  | 矮额  | 挨饿  | 
aiei | 爱诶   | 爱诶  | 哎诶  | 哎诶  | 唉诶  | 唉诶  | 矮诶  | 矮诶  | 挨诶  | 挨诶  | 艾诶  | 艾诶  | AI诶  | 哀诶  | 哀诶  | 癌诶  | 
aien | 爱恩   | 爱恩  | 哎嗯  | 哎嗯  | AI嗯  | 唉嗯  | 唉嗯  | 矮嗯  | 矮嗯  | 挨嗯  | 挨嗯  | 艾嗯  | 艾嗯  | 哀嗯  | 哀嗯  | 癌嗯  | 
aieng | 爱鞥   | 爱鞥  | 哎鞥  | 哎鞥  | AI鞥  | 唉鞥  | 唉鞥  | 矮鞥  | 矮鞥  | 挨鞥  | 挨鞥  | 艾鞥  | 艾鞥  | 哀鞥  | 哀鞥  | 癌鞥  | 
aier | 艾尔   | 爱尔   | 埃尔   | 爱儿   | 艾儿   | 爱耳   | 爱尔  | 哎二  | 哎二  | AI二  | 唉二  | 唉二  | 矮二  | 矮二  | 挨二  | 挨二  | 
aifa | 挨罚   | 爱发   | 爱发  | 哎发  | 哎发  | AI发  | 唉发  | 唉发  | 矮发  | 矮发  | 挨罚  | 艾发  | 艾发  | 哀发  | 哀发  | 癌发  | 
aifan | 爱返   | 爱返  | 哎饭  | 哎饭  | 唉饭  | 唉饭  | 矮饭  | 矮饭  | 挨饭  | 挨饭  | 艾饭  | 艾饭  | AI饭  | 哀饭  | 哀饭  | 癌饭  | 
aifang | 爱芳   | 爱房   | 爱芳  | 哎放  | 哎放  | 唉放  | 唉放  | 矮放  | 矮放  | 挨放  | 挨放  | 艾放  | 艾放  | AI放  | 哀放  | 哀放  | 
aifei | 爱妃   | 艾菲   | 爱飞   | 艾飞   | 爱飞  | 哎飞  | 哎飞  | 唉飞  | 唉飞  | 矮飞  | 矮飞  | 挨飞  | 挨飞  | 艾菲  | AI飞  | 哀飞  | 
aifen | 爱芬   | 艾芬   | 爱芬  | 哎分  | 哎分  | 唉分  | 唉分  | 矮分  | 矮分  | 挨分  | 挨分  | 艾分  | 艾分  | AI分  | 哀分  | 哀分  | 
aifeng | 爱疯   | 爱凤   | 艾丰   | 爱疯  | 哎风  | 哎风  | AI风  | 唉风  | 唉风  | 矮风  | 矮风  | 挨风  | 挨风  | 艾丰  | 哀风  | 哀风  | 
aifiao | 爱覅   | 爱覅  | 哎覅  | 哎覅  | AI覅  | 唉覅  | 唉覅  | 矮覅  | 矮覅  | 挨覅  | 挨覅  | 艾覅  | 艾覅  | 哀覅  | 哀覅  | 癌覅  | 
aifo | 艾佛   | 爱佛  | 爱佛  | 哎佛  | 哎佛  | AI佛  | 唉佛  | 唉佛  | 矮佛  | 矮佛  | 挨佛  | 挨佛  | 艾佛  | 哀佛  | 哀佛  | 癌佛  | 
aifou | 爱否   | 爱fou  | 哎fou  | AIfou  | 唉fou  | 矮fou  | 挨fou  | 艾fou  | 哀fou  | 癌fou  | 碍fou  | 埃fou  | 嗳fou  | 捱fou  | 暧fou  | 愛fou  | 
aifu | 爱抚   | 爱芙   | 爱抚  | 哎付  | 哎付  | 唉付  | 唉付  | 矮付  | 矮付  | 挨付  | 挨付  | 艾付  | 艾付  | AI付  | 哀付  | 哀付  | 
aiga | 爱噶   | 爱噶  | 哎噶  | 哎噶  | 唉噶  | 唉噶  | 矮噶  | 矮噶  | 挨噶  | 挨噶  | 艾噶  | 艾噶  | AI噶  | 哀噶  | 哀噶  | 癌噶  | 
aigai | 爱改   | 爱改  | 哎该  | 哎该  | 唉该  | 唉该  | 矮该  | 矮该  | 挨该  | 挨该  | 艾该  | 艾该  | AI该  | 哀该  | 哀该  | 癌该  | 
aigan | 爱干   | 爱干  | 哎干  | 哎干  | 唉干  | 唉干  | 矮干  | 矮干  | 挨干  | 挨干  | 艾干  | 艾干  | AI干  | 哀干  | 哀干  | 癌干  | 
aigang | 爱岗   | 爱港   | 爱岗  | 哎刚  | 哎刚  | AI刚  | 唉刚  | 唉刚  | 矮刚  | 矮刚  | 挨刚  | 挨刚  | 艾刚  | 艾刚  | 哀刚  | 哀刚  | 
aigao | 爱搞   | 艾高   | 哀告   | 癌噶哦  | 哀噶哦  | 艾噶哦  | 挨噶哦  | 矮噶哦  | 唉噶哦  | 爱噶哦  | 哎噶哦  | 爱搞  | 哎高  | 哎高  | AI高  | 唉高  | 
aige | 挨个   | 艾格   | 爱格   | 矮个   | 哀歌   | 爱歌   | 爱哥   | 爱格  | 哎个  | 哎个  | AI个  | 唉个  | 唉个  | 矮个  | 挨个  | 艾格  | 
aigei | 爱给   | 爱给  | 哎给  | 哎给  | AI给  | 唉给  | 唉给  | 矮给  | 矮给  | 挨给  | 挨给  | 艾给  | 艾给  | 哀给  | 哀给  | 癌给  | 
aigen | 爱跟   | 矮跟   | 爱gen  | 哎gen  | 唉gen  | 矮gen  | 挨gen  | 艾gen  | AIgen  | 哀gen  | 癌gen  | 碍gen  | 埃gen  | 嗳gen  | 捱gen  | 暧gen  | 
aigeng | 爱更   | 爱更  | 哎更  | 哎更  | 唉更  | 唉更  | 矮更  | 矮更  | 挨更  | 挨更  | 艾更  | 艾更  | AI更  | 哀更  | 哀更  | 癌更  | 
aigong | 艾工   | 爱工  | 爱工  | 哎工  | 哎工  | 唉工  | 唉工  | 矮工  | 矮工  | 挨工  | 挨工  | 艾工  | AI工  | 哀工  | 哀工  | 癌工  | 
aigou | 爱狗   | 爱购   | 爱狗  | 哎够  | 哎够  | 唉够  | 唉够  | 矮够  | 矮够  | 挨够  | 挨够  | 艾够  | 艾够  | AI够  | 哀够  | 哀够  | 
aigu | 艾古   | 癌股   | 爱股  | 爱股  | 哎古  | 哎古  | AI古  | 唉古  | 唉古  | 矮古  | 矮古  | 挨古  | 挨古  | 艾古  | 哀古  | 哀古  | 
aigua | 矮瓜   | 哀古啊  | 挨古啊  | 矮古啊  | 唉古啊  | 哎古啊  | 爱股啊  | 爱挂  | 爱挂  | 哎挂  | 哎挂  | AI挂  | 唉挂  | 唉挂  | 矮瓜  | 挨挂  | 
aiguai | 爱顾爱   | 哀古爱  | 哀古爱  | 挨古爱  | 挨古爱  | 矮古爱  | 矮古爱  | 唉古爱  | 唉古爱  | 哎古爱  | 哎古爱  | 爱股爱  | 爱股爱  | 爱鼓爱  | 爱鼓爱  | 哎鼓爱  | 
aiguan | 爱管   | 哀古按  | 哀古按  | 挨古按  | 挨古按  | 矮古按  | 矮古按  | 唉古按  | 唉古按  | 哎古按  | 爱股按  | 哎古按  | 爱股按  | 爱管  | 哎管  | 哎管  | 
aiguang | 爱光   | 哀古昂  | 挨古昂  | 哀古昂  | 矮古昂  | 哀古昂  | 矮古昂  | 唉古昂  | 唉古昂  | 哎古昂  | 哎古昂  | 爱股昂  | 哎古昂  | 爱光  | 哎古昂  | AI古昂  | 
aigui | 矮柜   | 爱贵  | 爱贵  | 哎贵  | 哎贵  | AI贵  | 唉贵  | 唉贵  | 矮柜  | 挨贵  | 挨贵  | 艾贵  | 艾贵  | 哀贵  | 哀贵  | 癌贵  | 
aigun | 爱滚   | 爱滚  | 哎滚  | 哎滚  | AI滚  | 唉滚  | 唉滚  | 矮滚  | 矮滚  | 挨滚  | 挨滚  | 艾滚  | 艾滚  | 哀滚  | 哀滚  | 癌滚  | 
aiguo | 爱国   | 爱过   | 挨过   | 碍国   | 矮古哦  | 挨古哦  | 哀古哦  | 爱股哦  | 唉古哦  | 哎古哦  | 爱过  | 哎过  | 哎过  | AI过  | 唉过  | 唉过  | 
aiha | 艾哈   | 爱哈  | 爱哈  | 哎哈  | 哎哈  | 唉哈  | 唉哈  | 矮哈  | 矮哈  | 挨哈  | 挨哈  | 艾哈  | AI哈  | 哀哈  | 哀哈  | 癌哈  | 
aihai | 爱海   | 爱海  | 哎还  | 哎还  | 唉还  | 唉还  | 矮还  | 矮还  | 挨还  | 挨还  | 艾还  | 艾还  | AI还  | 哀还  | 哀还  | 癌还  | 
aihan | 艾晗   | 爱喊  | 爱喊  | 哎喊  | 哎喊  | 唉喊  | 唉喊  | 矮喊  | 矮喊  | 挨喊  | 挨喊  | 艾晗  | AI喊  | 哀喊  | 哀喊  | 癌喊  | 
aihang | 埃航   | 爱行   | 爱行  | 哎行  | 哎行  | 唉行  | 唉行  | 矮行  | 矮行  | 挨行  | 挨行  | 艾行  | 艾行  | AI行  | 哀行  | 哀行  | 
aihao | 爱好   | 哀嚎   | 艾蒿   | 哀号   | 癌哈哦  | 哀哈哦  | 矮哈哦  | 挨哈哦  | 唉哈哦  | 哎哈哦  | 爱哈哦  | 爱好  | 哎好  | 哎好  | AI好  | 唉好  | 
aihe | 爱河   | 爱喝   | 爱和   | 嗳呵   | 爱禾   | 爱和  | 哎和  | 哎和  | AI和  | 唉和  | 唉和  | 矮和  | 矮和  | 挨和  | 挨和  | 艾和  | 
aihei | 哎嘿   | 爱黑  | 爱黑  | 哎嘿  | AI黑  | 唉黑  | 唉黑  | 矮黑  | 矮黑  | 挨黑  | 挨黑  | 艾黑  | 艾黑  | 哀黑  | 哀黑  | 癌黑  | 
aihen | 爱恨   | 爱hen  | 哎hen  | AIhen  | 唉hen  | 矮hen  | 挨hen  | 艾hen  | 哀hen  | 癌hen  | 碍hen  | 埃hen  | 嗳hen  | 捱hen  | 暧hen  | 愛hen  | 
aiheng | 艾恒   | 爱哼  | 爱哼  | 哎哼  | 哎哼  | 唉哼  | 唉哼  | 矮哼  | 矮哼  | 挨哼  | 挨哼  | 艾恒  | AI哼  | 哀哼  | 哀哼  | 癌哼  | 
aihm | 爱很美   | 爱荷美   | 爱好吗   | 癌哼吗  | 癌哼吗  | 哀哼吗  | 哀哼吗  | 挨哼吗  | 挨哼吗  | 矮哼吗  | 矮哼吗  | 唉哼吗  | 唉哼吗  | 哎哼吗  | 哎哼吗  | 爱哼吗  | 
aihng | 爱红   | 爱好难过   | 爱护你个  | 爱护你个  | 癌哼那个  | 癌哼那个  | 哀哼那个  | 哀哼那个  | 挨哼那个  | 挨哼那个  | 矮哼那个  | 矮哼那个  | 唉哼那个  | 唉哼那个  | 哎哼那个  | 哎哼那个  | 
aihong | 爱红   | 爱红  | 哎红  | 哎红  | AI红  | 唉红  | 唉红  | 矮红  | 矮红  | 挨红  | 挨红  | 艾红  | 艾红  | 哀红  | 哀红  | 癌红  | 
aihou | 爱后   | 爱后  | 哎后  | 哎后  | AI后  | 唉后  | 唉后  | 矮后  | 矮后  | 挨后  | 挨后  | 艾后  | 艾后  | 哀后  | 哀后  | 癌后  | 
aihu | 爱护   | 艾虎   | 挨户   | 爱护  | 哎胡  | 哎胡  | AI胡  | 唉胡  | 唉胡  | 矮胡  | 矮胡  | 挨户  | 艾虎  | 哀胡  | 哀胡  | 癌胡  | 
aihua | 爱华   | 爱花   | 艾华   | 矮化   | 癌胡啊  | 哀胡啊  | 矮胡啊  | 唉胡啊  | 哎胡啊  | 爱华  | 哎话  | 哎话  | AI话  | 唉话  | 唉话  | 矮化  | 
aihuai | 爱坏   | 癌胡爱  | 癌胡爱  | 哀胡爱  | 哀胡爱  | 矮胡爱  | 矮胡爱  | 唉胡爱  | 唉胡爱  | 哎胡爱  | 哎胡爱  | 爱坏  | 哎虎爱  | 哎虎爱  | AI虎爱  | 唉虎爱  | 
aihuan | 爱换   | 癌胡按  | 癌胡按  | 哀胡按  | 哀胡按  | 矮胡按  | 矮胡按  | 唉胡按  | 唉胡按  | 哎胡按  | 哎胡按  | 爱换  | 哎换  | 哎换  | 唉换  | 唉换  | 
aihuang | 哀黄   | 癌胡昂  | 癌胡昂  | 哀胡昂  | 哀胡昂  | 矮胡昂  | 哀胡昂  | 唉胡昂  | 唉胡昂  | 哎胡昂  | 哎胡昂  | 爱黄  | 爱黄  | 哎黄  | 哎黄  | 唉黄  | 
aihui | 爱会   | 爱辉   | 瑷珲   | 艾回   | 爱会  | 哎会  | 哎会  | 唉会  | 唉会  | 矮会  | 矮会  | 挨会  | 挨会  | 艾会  | 艾会  | AI会  | 
aihun | 瑷珲   | 爱混  | 爱混  | 哎混  | 哎混  | 唉混  | 唉混  | 矮混  | 矮混  | 挨混  | 挨混  | 艾混  | 艾混  | AI混  | 哀混  | 哀混  | 
aihuo | 爱火   | 艾火   | 矮胡哦  | 癌胡哦  | 唉胡哦  | 哀胡哦  | 哎胡哦  | 爱火  | 哎或  | 哎或  | AI或  | 唉或  | 唉或  | 矮或  | 矮或  | 挨或  | 
aiji | 埃及   | 爱机   | 爱机  | 哎几  | 哎几  | AI几  | 唉几  | 唉几  | 矮几  | 矮几  | 挨几  | 挨几  | 艾几  | 艾几  | 哀几  | 哀几  | 
aijia | 爱家   | 哀家   | 挨家   | 艾佳   | 爱佳   | 爱加   | 艾嘉   | 爱嘉   | 哀几啊  | 艾几啊  | 挨几啊  | 矮几啊  | 唉几啊  | 哎几啊  | 爱家  | 哎家  | 
aijian | 挨肩   | 爱建   | 哀几按  | 哀几按  | 艾几按  | 艾几按  | 挨几按  | 挨几按  | 矮几按  | 矮几按  | 唉几按  | 唉几按  | 哎几按  | 哎几按  | 爱建  | 哎见  | 
aijiang | 爱酱   | 爱将   | 哀几昂  | 哀几昂  | 艾几昂  | 艾几昂  | 挨几昂  | 挨几昂  | 矮几昂  | 矮几昂  | 唉几昂  | 唉几昂  | 哎几昂  | 哎几昂  | 爱将  | 哎讲  | 
aijiao | 挨浇   | 矮脚   | 爱叫   | 艾吉奥   | 爱娇   | 哎家哦  | 哀几奥  | 哀几奥  | 艾几奥  | 艾几奥  | 挨几奥  | 矮几奥  | 挨几奥  | 矮几奥  | 唉几奥  | 唉几奥  | 
aijie | 娭毑   | 爱姐   | 爱杰   | 艾几额  | 哀几额  | 哀几额  | 艾几额  | 挨几额  | 矮几额  | 挨几额  | 矮几额  | 唉几额  | 唉几额  | 哎几额  | 哎几额  | 爱姐  | 
aijin | 挨近   | 哀矜   | 爱进  | 爱进  | 哎进  | 哎进  | 唉进  | 唉进  | 矮进  | 矮进  | 挨近  | 艾进  | 艾进  | AI进  | 哀矜  | 癌进  | 
aijing | 爱敬   | 艾静   | 爱静   | 艾晶   | 爱警   | 爱静  | 哎经  | 哎经  | AI经  | 唉经  | 唉经  | 矮经  | 矮经  | 挨经  | 挨经  | 艾静  | 
aijiong | 艾炯   | 爱囧  | 爱囧  | 哎囧  | 哎囧  | AI囧  | 唉囧  | 唉囧  | 矮囧  | 矮囧  | 挨囧  | 挨囧  | 艾炯  | 哀囧  | 哀囧  | 癌囧  | 
aijiu | 艾灸   | 爱就   | 爱就  | 哎就  | 哎就  | AI就  | 唉就  | 唉就  | 矮就  | 矮就  | 挨就  | 挨就  | 艾灸  | 哀就  | 哀就  | 癌就  | 
aiju | 爱菊   | 爱菊  | 哎句  | 哎句  | AI句  | 唉句  | 唉句  | 矮句  | 矮句  | 挨句  | 挨句  | 艾句  | 艾句  | 哀句  | 哀句  | 癌句  | 
aijuan | 爱娟   | 癌句按  | 癌句按  | 哀句按  | 哀句按  | 艾句按  | 艾句按  | 挨句按  | 挨句按  | 矮句按  | 矮句按  | 唉句按  | 唉句按  | 哎句按  | 哎句按  | 爱娟  | 
aijue | 艾爵   | 挨决   | 癌句额  | 癌句额  | 哀句额  | 哀句额  | 艾句额  | 艾句额  | 挨句额  | 挨句额  | 矮句额  | 矮句额  | 唉句额  | 唉句额  | 哎句额  | 哎句额  | 
aijun | 爱军   | 爱君   | 艾军   | 爱军  | 哎军  | 哎军  | AI军  | 唉军  | 唉军  | 矮军  | 矮军  | 挨军  | 挨军  | 艾军  | 哀军  | 哀军  | 
aika | 爱卡   | 艾卡   | 爱卡  | 哎卡  | 哎卡  | AI卡  | 唉卡  | 唉卡  | 矮卡  | 矮卡  | 挨卡  | 挨卡  | 艾卡  | 哀卡  | 哀卡  | 癌卡  | 
aikai | 爱开   | 爱开  | 哎开  | 哎开  | 唉开  | 唉开  | 矮开  | 矮开  | 挨开  | 挨开  | 艾开  | 艾开  | AI开  | 哀开  | 哀开  | 癌开  | 
aikan | 爱看   | 爱看  | 哎看  | 哎看  | 唉看  | 唉看  | 矮看  | 矮看  | 挨看  | 挨看  | 艾看  | 艾看  | AI看  | 哀看  | 哀看  | 癌看  | 
aikang | 爱康   | 艾康   | 爱康  | 哎抗  | 哎抗  | 唉抗  | 唉抗  | 矮抗  | 矮抗  | 挨抗  | 挨抗  | 艾康  | AI抗  | 哀抗  | 哀抗  | 癌抗  | 
aikao | 爱考   | 癌卡哦  | 挨卡哦  | 哀卡哦  | 矮卡哦  | 唉卡哦  | 哎卡哦  | 爱考  | 哎靠  | 哎靠  | 唉靠  | 唉靠  | 矮靠  | 矮靠  | 挨靠  | 挨靠  | 
aike | 艾克   | 艾科   | 爱客   | 爱克   | 艾可   | 爱克  | 哎可  | 哎可  | AI可  | 唉可  | 唉可  | 矮可  | 矮可  | 挨可  | 挨可  | 艾克  | 
aikei | 爱尅   | 爱尅  | 哎尅  | 哎尅  | AI尅  | 唉尅  | 唉尅  | 矮尅  | 矮尅  | 挨尅  | 挨尅  | 艾尅  | 艾尅  | 哀尅  | 哀尅  | 癌尅  | 
aiken | 艾肯   | 爱肯   | 爱肯  | 哎肯  | 哎肯  | AI肯  | 唉肯  | 唉肯  | 矮肯  | 矮肯  | 挨肯  | 挨肯  | 艾肯  | 哀肯  | 哀肯  | 癌肯  | 
aikeng | 爱坑   | 爱坑  | 哎坑  | 哎坑  | AI坑  | 唉坑  | 唉坑  | 矮坑  | 矮坑  | 挨坑  | 挨坑  | 艾坑  | 艾坑  | 哀坑  | 哀坑  | 癌坑  | 
aikong | 爱空   | 爱空  | 哎空  | 哎空  | AI空  | 唉空  | 唉空  | 矮空  | 矮空  | 挨空  | 挨空  | 艾空  | 艾空  | 哀空  | 哀空  | 癌空  | 
aikou | 碍口   | 隘口   | 爱口  | 爱口  | 哎口  | 哎口  | AI口  | 唉口  | 唉口  | 矮口  | 矮口  | 挨口  | 挨口  | 艾口  | 艾口  | 哀口  | 
aiku | 爱哭   | 爱酷   | 哀苦   | 爱哭  | 哎哭  | 哎哭  | AI哭  | 唉哭  | 唉哭  | 矮哭  | 矮哭  | 挨哭  | 挨哭  | 艾哭  | 艾哭  | 哀苦  | 
aikua | 爱夸   | 艾哭啊  | 挨哭啊  | 矮哭啊  | 唉哭啊  | 哎哭啊  | 爱夸  | 哎夸  | 哎夸  | AI夸  | 唉夸  | 唉夸  | 矮夸  | 矮夸  | 挨夸  | 挨夸  | 
aikuai | 爱快   | 艾哭爱  | 爱哭爱   | 艾哭爱  | 挨哭爱  | 挨哭爱  | 矮哭爱  | 矮哭爱  | 唉哭爱  | 唉哭爱  | 哎哭爱  | 哎哭爱  | 爱快  | 哎快  | 哎快  | 唉快  | 
aikuan | 矮款   | 艾哭按  | 艾哭按  | 挨哭按  | 挨哭按  | 矮哭按  | 矮哭按  | 唉哭按  | 唉哭按  | 哎哭按  | 哎哭按  | 爱骷按  | 爱骷按  | 哎骷按  | 哎骷按  | 唉骷按  | 
aikuang | 艾匡   | 艾哭昂  | 艾哭昂  | 挨哭昂  | 矮哭昂  | 挨哭昂  | 矮哭昂  | 唉哭昂  | 唉哭昂  | 哎哭昂  | 哎哭昂  | 爱狂  | 爱狂  | 哎狂  | 哎狂  | 唉狂  | 
aikui | 艾奎   | 爱亏  | 爱亏  | 哎亏  | 哎亏  | 唉亏  | 唉亏  | 矮亏  | 矮亏  | 挨亏  | 挨亏  | 艾奎  | AI亏  | 哀亏  | 哀亏  | 癌亏  | 
aikun | 爱困   | 爱坤   | 爱困  | 哎困  | 哎困  | AI困  | 唉困  | 唉困  | 矮困  | 矮困  | 挨困  | 挨困  | 艾困  | 艾困  | 哀困  | 哀困  | 
aikuo | 艾阔   | 艾哭哦  | 矮哭哦  | 挨哭哦  | 唉哭哦  | 哎哭哦  | 爱扩  | 爱扩  | 哎扩  | 哎扩  | AI扩  | 唉扩  | 唉扩  | 矮扩  | 矮扩  | 挨扩  | 
aila | 艾拉   | 爱啦  | 爱啦  | 哎啦  | 哎啦  | AI啦  | 唉啦  | 唉啦  | 矮啦  | 矮啦  | 挨啦  | 挨啦  | 艾拉  | 哀啦  | 哀啦  | 癌啦  | 
ailai | 爱来   | 爱来  | 哎来  | 哎来  | AI来  | 唉来  | 唉来  | 矮来  | 矮来  | 挨来  | 挨来  | 艾来  | 艾来  | 哀来  | 哀来  | 癌来  | 
ailan | 爱兰   | 艾岚   | 爱兰  | 哎蓝  | 哎蓝  | AI蓝  | 唉蓝  | 唉蓝  | 矮蓝  | 矮蓝  | 挨蓝  | 挨蓝  | 艾蓝  | 艾蓝  | 哀蓝  | 哀蓝  | 
ailang | 爱浪   | 爱浪  | 哎狼  | 哎狼  | AI狼  | 唉狼  | 唉狼  | 矮狼  | 矮狼  | 挨狼  | 挨狼  | 艾狼  | 艾狼  | 哀狼  | 哀狼  | 癌狼  | 
ailao | 爱老   | 癌啦哦  | 哀啦哦  | 矮啦哦  | 挨啦哦  | 唉啦哦  | 哎啦哦  | 爱啦哦  | 爱老  | 哎老  | 哎老  | AI老  | 唉老  | 唉老  | 矮老  | 矮老  | 
aile | 爱了   | 矮了   | 挨了   | 哀乐   | Aileen   | 艾乐   | 爱了  | 哎了  | 哎了  | 唉了  | 唉了  | 矮了  | 挨了  | 艾乐  | AI了  | 哀乐  | 
ailei | 艾蕾   | 挨累   | 爱累  | 爱累  | 哎累  | 哎累  | 唉累  | 唉累  | 矮累  | 矮累  | 挨累  | 艾蕾  | AI累  | 哀累  | 哀累  | 癌累  | 
ailen | 哀乐呢   | 哀乐呢   | 唉了你  | 唉了你  | 哎了你  | 哎了你  | 爱了你  | 爱了你  | 矮了你  | 矮了你  | 挨了你  | 挨了你  | 哀乐你  | 哀乐你  | 艾乐你  | 艾乐你  | 
aileng | 爱冷   | 爱冷  | 哎冷  | 哎冷  | 唉冷  | 唉冷  | 矮冷  | 矮冷  | 挨冷  | 挨冷  | 艾冷  | 艾冷  | AI冷  | 哀冷  | 哀冷  | 癌冷  | 
aili | 爱丽   | 艾力   | 艾利   | 艾丽   | ailing   | 艾黎   | 艾莉   | 爱莉   | 爱理   | 爱力   | 爱丽  | 哎里  | 哎里  | AI里  | 唉里  | 唉里  | 
ailia | 爱丽啊   | 唉里啊  | 哎里啊  | 爱俩  | 爱俩  | 哎俩  | 哎俩  | AI俩  | 唉俩  | 唉俩  | 矮俩  | 矮俩  | 挨俩  | 挨俩  | 艾俩  | 艾俩  | 
ailian | 爱恋   | 爱怜   | 爱联   | 爱莲   | 哀怜   | 爱链   | 唉里按  | 唉里按  | 哎里按  | 哎里按  | 爱恋  | 哎连  | 哎连  | AI连  | 唉连  | 唉连  | 
ailiang | 艾亮   | 唉里昂  | 爱良   | 爱恋过   | 唉里昂  | 哎里昂  | 哎里昂  | 爱良  | 哎里昂  | 唉里昂  | 矮两  | 矮两  | 挨两  | 挨两  | 艾亮  | AI两  | 
ailiao | 爱聊   | 艾俩哦  | 挨俩哦  | 矮俩哦  | 唉俩哦  | 哎俩哦  | 爱俩哦  | 爱丽啊哦  | 唉里奥  | 唉里奥  | 哎里奥  | 哎里奥  | 爱聊  | 哎里奥  | 唉里奥  | 矮聊  | 
ailie | 艾烈   | 唉里额  | 唉里额  | 哎里额  | 哎里额  | 爱列  | 爱列  | 哎列  | 哎列  | 唉列  | 唉列  | 矮列  | 矮列  | 挨列  | 挨列  | 艾烈  | 
ailin | 艾琳   | 爱林   | 挨淋   | 爱琳   | ailing   | 艾林   | 爱林  | 哎林  | 哎林  | 唉林  | 唉林  | 矮林  | 矮林  | 挨淋  | 艾琳  | AI林  | 
ailing | ailing   | 爱玲   | 爱灵   | 爱玲  | 哎领  | 哎领  | 唉领  | 唉领  | 矮领  | 矮领  | 挨领  | 挨领  | 艾领  | 艾领  | AI领  | 哀领  | 
ailiu | 癌瘤   | 爱留  | 爱留  | 哎留  | 哎留  | AI留  | 唉留  | 唉留  | 矮留  | 矮留  | 挨留  | 挨留  | 艾留  | 艾留  | 哀留  | 哀留  | 
ailo | 爱咯   | 爱咯  | 哎咯  | 哎咯  | AI咯  | 唉咯  | 唉咯  | 矮咯  | 矮咯  | 挨咯  | 挨咯  | 艾咯  | 艾咯  | 哀咯  | 哀咯  | 癌咯  | 
ailong | 爱龙   | 爱龙  | 哎龙  | 哎龙  | AI龙  | 唉龙  | 唉龙  | 矮龙  | 矮龙  | 挨龙  | 挨龙  | 艾龙  | 艾龙  | 哀龙  | 哀龙  | 癌龙  | 
ailou | 艾楼   | 爱楼  | 爱楼  | 哎楼  | 哎楼  | AI楼  | 唉楼  | 唉楼  | 矮楼  | 矮楼  | 挨楼  | 挨楼  | 艾楼  | 哀楼  | 哀楼  | 癌楼  | 
ailu | 艾路   | 隘路   | 艾露   | 爱路  | 爱路  | 哎路  | 哎路  | AI路  | 唉路  | 唉路  | 矮路  | 矮路  | 挨路  | 挨路  | 艾路  | 哀路  | 
ailuan | 爱乱   | 哀路按  | 哀路按  | 挨路按  | 挨路按  | 矮路按  | 矮路按  | 唉路按  | 唉路按  | 哎路按  | 哎路按  | 爱路按  | 爱路按  | 爱乱  | 哎乱  | 哎乱  | 
ailun | 艾伦   | 爱伦   | 爱伦  | (ㅎ-ㅎ;)←艾伦   | 哎轮  | 哎轮  | AI轮  | 唉轮  | 唉轮  | 矮轮  | 矮轮  | 挨轮  | 挨轮  | 艾伦  | 哀轮  | 哀轮  | 
ailuo | 爱罗   | 艾罗   | 哀路哦  | 挨路哦  | 矮路哦  | 唉路哦  | 哎路哦  | 爱路哦  | 爱罗  | 哎罗  | 哎罗  | AI罗  | 唉罗  | 唉罗  | 矮罗  | 矮罗  | 
ailv | 爱侣   | 哀绿   | 爱绿   | 爱侣  | 哎绿  | 哎绿  | AI绿  | 唉绿  | 唉绿  | 矮绿  | 矮绿  | 挨绿  | 挨绿  | 艾绿  | 艾绿  | 哀绿  | 
ailve | 艾略   | 艾绿额  | 艾绿额  | 挨绿额  | 挨绿额  | 矮绿额  | 矮绿额  | 唉绿额  | 唉绿额  | 哎绿额  | 哎绿额  | 爱驴额  | 爱驴额  | 哎驴额  | 哎驴额  | AI驴额  | 
aim | 艾玛   | 暧昧   | 挨骂   | 爱美   | 爱慕   | 艾米   | 爱民   | 艾美   | 爱买   | 爱玛   | 爱明   | 爱么   | 爱猫   | 爱吗   | 爱面   | 挨门   | 
aima | 艾玛   | 挨骂   | 爱玛   | 爱吗   | 哎嘛   | 矮马   | 爱马   | 爱吗  | 哎嘛  | AI吗  | 唉吗  | 唉吗  | 矮马  | 挨骂  | 艾玛  | 哀吗  | 
aimai | 爱买   | 爱迈   | 爱麦   | 爱买  | 哎买  | 哎买  | 唉买  | 唉买  | 矮买  | 矮买  | 挨买  | 挨买  | 艾买  | 艾买  | AI买  | 哀买  | 
aiman | 艾曼   | 爱慢  | 爱慢  | 哎慢  | 哎慢  | 唉慢  | 唉慢  | 矮慢  | 矮慢  | 挨慢  | 挨慢  | 艾曼  | AI慢  | 哀慢  | 哀慢  | 癌慢  | 
aimang | 爱忙   | 爱忙  | 哎忙  | 哎忙  | 唉忙  | 唉忙  | 矮忙  | 矮忙  | 挨忙  | 挨忙  | 艾忙  | 艾忙  | AI忙  | 哀忙  | 哀忙  | 癌忙  | 
aimao | 爱猫   | 哀吗哦  | 唉吗哦  | 爱猫  | 哎毛  | 哎毛  | 唉毛  | 唉毛  | 矮毛  | 矮毛  | 艾玛哦  | 挨毛  | 挨毛  | 艾毛  | 艾毛  | AI毛  | 
aime | 爱么   | 爱么  | 哎么  | 哎么  | Aimee   | AI么  | 唉么  | 唉么  | 矮么  | 矮么  | 挨么  | 挨么  | 艾么  | 艾么  | 哀么  | 哀么  | 
aimei | 暧昧   | 爱美   | 艾美   | 爱梅   | 爱妹   | 爱美  | 哎没  | 哎没  | AI没  | 唉没  | 唉没  | 矮没  | 矮没  | 挨没  | 挨没  | 艾美  | 
aimen | 挨门   | 爱们  | 爱们  | 哎们  | 哎们  | AI们  | 唉们  | 唉们  | 矮们  | 矮们  | 挨门  | 艾们  | 艾们  | 哀们  | 哀们  | 癌们  | 
aimeng | 爱梦   | 爱蒙   | 挨蒙   | 爱梦  | 哎梦  | 哎梦  | AI梦  | 唉梦  | 唉梦  | 矮梦  | 矮梦  | 挨梦  | 挨梦  | 艾梦  | 艾梦  | 哀梦  | 
aimi | 艾米   | 埃米   | 爱米  | 爱米  | 哎米  | 哎米  | AI米  | 唉米  | 唉米  | 矮米  | 矮米  | 挨米  | 挨米  | 艾米  | 哀米  | 哀米  | 
aimian | 爱面   | 哀米按  | 哀米按  | 挨米按  | 挨米按  | 矮米按  | 矮米按  | 唉米按  | 唉米按  | 哎米按  | 哎米按  | 爱米按  | 爱米按  | 爱面  | 哎面  | 哎面  | 
aimiao | 爱喵   | 哀米奥  | 哀米奥  | 挨米奥  | 挨米奥  | 矮米奥  | 矮米奥  | 唉米奥  | 唉米奥  | 哎米奥  | 哎米奥  | 爱米奥  | 爱米奥  | 爱喵  | 哎秒  | 哎秒  | 
aimie | 爱迷额   | 哀米额  | 哀米额  | 挨米额  | 挨米额  | 矮米额  | 挨米额  | 唉米额  | 唉米额  | 哎米额  | 爱米额  | 哎米额  | 爱米额  | 爱迷额  | 哎迷额  | 哎迷额  | 
aimin | 爱民   | 艾敏   | 爱min  | 哎min  | 唉min  | 矮min  | 挨min  | 艾min  | AImin  | 哀min  | 癌min  | 碍min  | 埃min  | 嗳min  | 捱min  | 暧min  | 
aiming | 爱明   | 哀鸣   | 爱明  | 哎名  | 哎名  | 唉名  | 唉名  | 矮名  | 矮名  | 挨名  | 挨名  | 艾名  | 艾名  | AI名  | 哀鸣  | 癌名  | 
aimiu | 爱缪   | 爱谬  | 爱谬  | 哎谬  | 哎谬  | 唉谬  | 唉谬  | 矮谬  | 矮谬  | 挨谬  | 挨谬  | 艾谬  | 艾谬  | AI谬  | 哀谬  | 哀谬  | 
aimo | 哀默   | 艾莫   | 爱摸  | 爱摸  | 哎摸  | 哎摸  | AI摸  | 唉摸  | 唉摸  | 矮摸  | 矮摸  | 挨摸  | 挨摸  | 艾莫  | 哀默  | 癌摸  | 
aimou | 艾某   | 爱某  | 爱某  | 哎某  | 哎某  | AI某  | 唉某  | 唉某  | 矮某  | 矮某  | 挨某  | 挨某  | 艾某  | 哀某  | 哀某  | 癌某  | 
aimu | 爱慕   | 爱慕  | 哎木  | 哎木  | AI木  | 唉木  | 唉木  | 矮木  | 矮木  | 挨木  | 挨木  | 艾木  | 艾木  | 哀木  | 哀木  | 癌木  | 
ain | 爱你   | 爱您   | 欸乃   | 爱能   | 爱娜   | 艾尼   | 碍难   | 爱呢   | 艾诺   | 爱女   | 爱念   | 爱闹   | 爱诺   | 挨你   | 挨虐   | 爱宁   | 
aina | 爱娜   | 爱娜  | 哎那  | 哎那  | AI那  | 唉那  | 唉那  | 矮那  | 矮那  | 挨那  | 挨那  | 艾那  | 艾那  | 哀那  | 哀那  | 癌那  | 
ainai | 欸乃   | 爱奶  | 爱奶  | 哎奶  | 哎奶  | AI奶  | 唉奶  | 唉奶  | 矮奶  | 矮奶  | 挨奶  | 挨奶  | 艾奶  | 艾奶  | 哀奶  | 哀奶  | 
ainan | 碍难   | 爱男  | 爱男  | 哎男  | 哎男  | AI男  | 唉男  | 唉男  | 矮男  | 矮男  | 挨男  | 挨男  | 艾男  | 艾男  | 哀男  | 哀男  | 
ainang | 爱囊   | 爱囊  | 哎囊  | 哎囊  | AI囊  | 唉囊  | 唉囊  | 矮囊  | 矮囊  | 挨囊  | 挨囊  | 艾囊  | 艾囊  | 哀囊  | 哀囊  | 癌囊  | 
ainao | 爱闹   | 癌那哦  | 艾那哦  | 哀那哦  | 矮那哦  | 挨那哦  | 唉那哦  | 哎那哦  | 爱闹  | 哎闹  | 哎闹  | 唉闹  | 唉闹  | 矮闹  | 矮闹  | 挨闹  | 
aine | 爱呢   | 爱呢  | 哎呢  | 哎呢  | 唉呢  | 唉呢  | 矮呢  | 矮呢  | 挨呢  | 挨呢  | 艾呢  | 艾呢  | AI呢  | 哀呢  | 哀呢  | 癌呢  | 
ainei | 爱内   | 爱内  | 哎内  | 哎内  | 唉内  | 唉内  | 矮内  | 矮内  | 挨内  | 挨内  | 艾内  | 艾内  | AI内  | 哀内  | 哀内  | 癌内  | 
ainen | 爱嫩   | 爱嫩  | 哎嫩  | 哎嫩  | 唉嫩  | 唉嫩  | 矮嫩  | 矮嫩  | 挨嫩  | 挨嫩  | 艾嫩  | 艾嫩  | AI嫩  | 哀嫩  | 哀嫩  | 癌嫩  | 
aineng | 爱能   | 爱能  | 哎能  | 哎能  | AI能  | 唉能  | 唉能  | 矮能  | 矮能  | 挨能  | 挨能  | 艾能  | 艾能  | 哀能  | 哀能  | 癌能  | 
aing | 昂   | 盎   | 肮   | 爱那个   | 肮   | 哀能个  | 哀能个  | 艾能个  | 艾能个  | 挨能个  | 挨能个  | 矮能个  | 矮能个  | 唉能个  | 唉能个  | 哎能个  | 
aini | 爱你   | 艾尼   | 挨你   | (๑′ᴗ‵๑)Ｉ Lᵒᵛᵉᵧₒᵤ❤   | 艾妮   | 爱妮   | 碍你   | 僾尼   | 爱你  | 哎你  | 哎你  | AI你  | 唉你  | 唉你  | 矮你  | 矮你  | 
ainia | 爱你啊   | 爱念   | 爱鸟   | ~(｡≧3≦)ﾉ⌒☆   | 矮你啊  | 唉你啊  | 哎你啊  | 爱你啊  | 艾尼啊  | 挨你啊  | 艾妮啊  | 爱妮啊  | 碍你啊  | 僾尼啊  | 爱你啊  | 哎年  | 
ainian | 哎年   | 爱念   | 矮你按  | 矮你按  | 唉你按  | 唉你按  | 哎你按  | 哎你按  | 爱念  | 哎你按  | AI年  | 唉你按  | 矮你按  | 挨年  | 挨年  | 艾年  | 
